 
ຄູ່ມືເລກລະຫັດໄປສະນີ 05 ຕົວເລກ
ຂອງ ສປປ ລາວ(ສະບັບປັບປຸງ)






ກົມໄປສະນີ
ກະຊວງໄປສະນີ, ໂທລະຄົມມະນາຄົມ ແລະ ການສື່ສານ
ປີ 2018

 
ຄຳນຳ

	ລະຫັດໄປສະນີ (Postcode)ແມ່ນຕົວເລກຊີ້ບອກທີ່ຕັ້ງແລະຂອບເຂດສຳລັບການແຈກຢາຍເຄື່ອງຝາກທາງໄປສະນີ, ປະກອບດ້ວຍ 05 ຕົວເລກເຊີ່ງໄດ້ກຳນົດເປັນແຕ່ລະເຂດແຈກຢາຍພາຍໃນແຂວງ, ນະຄອນຫລວງ, ເມືອງ, ເທດສະບານ ແລະ ບ້ານ ທີ່ຂື້ນກັບຄວາມຮັບຜິດຊອບຂອງຫ້ອງການໄປສະນີ ປະຈຳຂົງເຂດນັ້ນ.

	ປື້ມຄູ່ມືນຳໃຊ້ລະຫັດໄປສະນີ ເຫຼັ້ມນີ້ ແມ່ນໄດ້ຮັບການປັບປຸງມາຈາກເຫຼັ້ມ ລົງວັນທີ 05 ພຶດສະພາ 2011, ການປັບປຸງຄັ້ງນີ້ແມ່ນເພື່ອກຳນົດລະຫັດໄປສະນີໃຫ້ເປັນລະບົບຄົບຊຸດ, ຖືກຕ້ອງຕາມການຈັດສັນເຄຫາຜັງເມືອງຂອງລັດຖະບານ ແລະ ໃຫ້ທົ່ວເຖິງໃນຂອບເຂດທົ່ວປະເທດ. ພ້ອມກັນນັ້ນ, ກໍ່ເພື່ອເປັນບ່ອນອີງໃນການຈັດຕັ້ງປະຕິບັດວຽກງານຂອງຂະແໜງການໄປສະນີ ໂດຍສະເພາະ ແມ່ນການບໍລິການແຈກຢາຍເຄື່ອງຝາກທາງໄປສະນີ ໃຫ້ຮັບປະກັນຄຸນນະພາບ, ມີຄວາມສະດວກ, ປອດໄພ, ວ່ອງໄວ ແລະ ເຖິງຜູ້ຮັບຕົງເວລາ. ນອກຈາກນີ້,ລະຫັດໄປສະນີ ຂອງ ສປປ ລາວ ກໍ່ເປັນຂໍ້ມູນທີ່ສຳຄັນເຊີ່ງຈະໄດ້ຖືກບັນທຶກເຂົ້າໃນຖານຂໍ້ມູນຂອງສະຫະພາບໄປສະນີ ສາກົນ ເພື່ອອຳນວຍຄວາມສະດວກໃຫ້ຜູ້ຊົມໃຊ້ການບໍລິການໄປສະນີໃນທົ່ວໂລກສາມາດເຂົ້າເຖິງໄດ້ງ່າຍ ແລະ ຮັບຮູ້ລະຫັດໄປສະນີ ຂອງ ສປປ ລາວ, ອີກດ້ານໜື່ງ ລະຫັດໄປສະນີແມ່ນມີຄວາມຈຳເປັນໃຫ້ແກ່ຜູ້ຊົມໃຊ້ການບໍລິການໄປສະນີ ໂດຍສະເພາະ ແມ່ນການຂຽນຊື່ທີ່ຢູ່ ຂອງຜູ້ຝາກ ແລະ ຜູ້ຮັບ ຈະຕ້ອງມີລະຫັດໄປສະນີປະກອບເຂົ້ານຳທຸກໆຄັ້ງ. ສະນັ້ນ, ຈື່ງຮຽກຮ້ອງມາຍັງພາກສ່ວນທີ່ກ່ຽວຂ້ອງ ຈົ່ງໄດ້ເອົາໃຈໃສ່ ນຳໃຊ້ປື້ມຄູ່ມືລະຫັດໄປສະນີ ເຫຼັ້ມນີ້ໃຫ້ເປັນເອກະພາບກັນ ແລະ ເກີດຜົນປະໂຫຍດສູງສຸດ.

	ຄະນະປັບປຸງ ຂໍສະແດງຄວາມຂອບໃຈມາຍັງທຸກພາກສ່ວນ ແລະ ມີຄວາມຍິນດີຮັບເອົາການຕຳນິຕິຊົມຈາກບັນດາທ່ານ ເພື່ອເຮັດໃຫ້ການປັບປຸງຄັ້ງຕໍ່ໄປດີກວ່າເກົ່າ.

ຂໍຂອບໃຈ
 









Content 
Vientioane capital 	Error! Bookmark not defined.
Post code 01000	1
Phong sa lee province 	8
Post code02000	8
Luangnamtha province	14
Post code03000	14
Oudomxai province 	18
Post code04000	18
Bokeo province	25
Post code 05000	25
Luargprabang province	28
Post code06000	28
Huaphan Province	39
Post code 07000	39
Xaiyabouly province	49
Post code08000	49
Xiengkhuang province	56
Post code09000	56
Vientiane province	62
Post code10000	62
Bolikhamxai province	69
Post code 11000	69
Khammouan province 	71
Post code12000	71
Savannakhed province	80
Post code13000	80
Salavanh province	92
Post code14000	92
Sekong Province	100
Post code15000	100
Champasak Province	101
Post code16000	101
Attapuea Province	111
Post code17000	111
Xaysomboun Province	113
Post code18000	113
 

Post code 01000
Vientiane 01XXX		
ໄປສະນີກາງ  01000 - 01006		
ລະຫັດໄປສະນີ ເຂດ 1: 01000		
Xiengnguen village	Vatchanthong village	Hathsady village	Haysoke village		
Mexai village	See hom village	Anou village	 		
Vatchantha village	Say lom village	Hathsady nuea Village	 		
ລະຫັດໄປສະນີ ເຂດ 2:  01001 		
Seethannuea village	Khounta village	Nong panay village	Nongsano kham Village		
Xiengwae village	Oumoung village	Vattainoytha village	Akard Village		
Hua mueang village	Nakham village	Vattainoythong Village	 		
ລະຫັດໄປສະນີ ເຂດ 3:  01002 		
Khualuangtai village	Nongduangthong 	Phonn sr vad tai	Nong peeng village		
Khualuagnuea Village	Hong kharnuea 	Nong buathongngnuea	Dongnasokenuea		
Nongdangnuea Village	Hongkhartai village	Nong buathongng tai	Dongnasoke tai		
Nongduangnuea Village	Thongtoum village	Huadong village	Pakthang village		
ລະຫັດໄປສະນີ ເຂດ 4:  01003 		
Thongkhankham 	Seedamduan village	Phontongchommany	Nongthatai		
See savad nuea	Seebouhueang 	Phontong sawath 	Huaghong		
See savad tai 	Thongsangnang 	Done daeny	Payang		
Dongmieng village	sawang	Nong thanuea	 		
ລະຫັດໄປສະນີ ເຂດ 5: 01004 		
Nongchan Village	Seesangvone Village	Nongsangthor Village	Hongxaeng Village		
Phonxay Village	Nongbone Village	Hongkaikeo Village	 		
Naxay Village	Phonsaath Village		 		
ລະຫັດໄປສະນີເຂດ 6:  01005		
Faiy	ບ້ານ ສະພານທອງກາງ	ບ້ານ ໂພນປ່າເປົ້າທົ່ງ	ບ້ານ ໂພນສະຫວັນໃຕ້		
Dongpalantha	ບ້ານ ສະພານທອງໃຕ້	ບ້ານ ດອນນົກຂຸ້ມ	 		
Phon seenuan	ບ້ານ ທົ່ງພານທອງ	ບ້ານ ໂສກປ່າຫຼວງ	 		
Saphantnongnuea	Phonpapao	Phonsavannuea	 		
ລະຫັດໄປສະນີ ເຂດ 7:  01006 		
Kaoyord	Thadkhao	Bueng nagong	vatnak		
Phiavat	Phaxay	Bueng khayongtai	Thong kavg		
Seemueang	Phapho	thaphalanxay	 		
ຫ້ອງການ ໄປສະນີສະໜາມບິນ ວັດໄຕ 01010		
ກົມການບິນພົນລະເຮືອນ	ກົມເຊື້ອໄຟ	ສາງການບິນລາວຕ່າງປະເທດ	ບ/ສ ການບິນລາວ		
ກົມຄຸ້ມຄອງການບິນລາວ	ກອງດັບເພີງ	ຕຶກສະໜາມບິນສາກົນ	ບ/ສ ລາວສະກາຍເວ		
ກົມຈາລະຈອນອາກາດ	ສາງການບິນລາວພາຍໃນ	ຕຶກສະໜາມບິນພາຍໃນ	 		
ຫ້ອງການໄປສະນີ ສີໄຄ 01020 - 01021		
ລະຫັດໄປສະນີ ເຂດ 1:  01020 		
Mueangvatha	Seebouneagthong	ບ້ານ ໜອງດາ	ບ້ານ ໂນນສະຫວ່າງ		
Muengvathong	Phosee	ບ້ານ ໃໝ່	ບ້ານ ນາແຮ		
Seekhaitha	Seexomxuen	ບ້ານ ອ່າງໃຫຍ່	ບ້ານ ວຽງສະຫວັນ		
Seekhaithong	Nonkeo	ບ້ານ ຕາດທອງ	 		
yapha	Kaoliew	ບ້ານ ໂພນສົມບູນ	 		
Seebouneangtha	Dank	ບ້ານ ໂພນສະຫວາດເໜືອ	 		
ລະຫັດໄປສະນີ ເຂດ 2:  01021		
ບ້ານ ທົ່ງປົ່ງ	ບ້ານ ໜອງແຕ່ງເໜືອ	ບ້ານ ໜອງບຶກໃຕ້	ບ້ານ ຫຼັກຫີນ		
ບ້ານ ນາເລົ່າ	ບ້ານ ຈັນສະຫວ່າງ	ບ້ານ ໜອງບຶກເໜືອ	ບ້ານ ດົງນາທອງ		
ບ້ານ ໜອງໜ່ຽວ	ບ້ານ ວຽງຄຳ	ບ້ານ ດົງກະເລົາ	 		
ບ້ານ ໜອງແຕ່ງໃຕ້	ບ້ານ ຈຳປາ	ບ້ານ ຊຳເກດ	 		
ຫ້ອງການໄປສະນີ ນາຊາຍທອງ 01030 - 01035		
ລະຫັດໄປສະນີ ເຂດ 1: 01030		
ບ້ານດົງຫລວງ	ບ້ານ ນາຊາຍກາງ	ບ້ານ ນາຄູນໃຕ້	ບ້ານ ດົງປອງ		
ບ້ານ ນາຊາຍໃຕ້	ບ້ານ ນາຊາຍເໜືອ	ບ້ານ ນາຄູນເໜືອ	ບ້ານ ໜອງຍາວ		
ລະຫັດໄປສະນີ ເຂດ 2: 01031		
ບ້ານໂພນສະຫວັນ	ບ້ານ ນາຊ່ຽວ	ບ້ານ ສີເກີດ	ບ້ານ ນາລຽນ		
ບ້ານ ໂພນແກ້ວ	ບ່ານ ໄຊມຸງຄຸນ	ບ້ານ ຜາງແຫ້ງ	ບ້ານ ປາກແຮດ		
ບ້ານ ດົງຊຽງດີ	 	 	 		
ລະຫັດໄປສະນີ ເຂດ 3: 01032		
ບ້ານຫົວຊ້າງ	ບ້ານ ນາຊອນ	ບ້ານ ໜອງຄັນຄູ	ບ້ານ ນໍ້າກ້ຽງເໜືອ		
ບ້ານ ດ່ານຊີ	ບ້ານ ນາຍາງ	ບ້ານ ນໍ້າກ້ຽງໃຕ້	ບ້ານ ນາຊັບ		
ບ້ານ ຫົວຂົວ	 	 	 		
ລະຫັດໄປສະນີ ເຂດ 4: 01033		
ບ້ານອີ່ໄລໃຕ້	ບ້ານ ນໍ້າເຢັນ	ບ້ານ ນາທອນ	ບ້ານ ນໍ້າຫຸມ		
ບ້ານ ອີ່ໄລເໜືອ	ບ້ານ ອ່າງນໍ້າຫຸມ	ບ້ານ ສົງເປືອຍໃຕ້	ບ້ານ ຫຸມແບ່ງ		
ບ້ານ ກາງແສນ	ບ້ານ ສີສະຫວາດ	ບ້ານ ສົງເປືອຍເໜືອ	ບ້ານ ເປີກ		
ບ້ານ ແຈ້ງສະຫ່ວາງ	 	 	 		
ລະຫັດໄປສະນີ ເຂດ 5: 01034		
ບ້ານໂພນມ່ວງ	ບ້ານ ໂພນຄໍາ	ບ້ານ ນານາດ	ບ້ານ ຖໍ້າ		
ບ້ານ ນາຂ່າ	ບ້ານ ຫົວນາ	ບ້ານ ຮ່ອງງົວ	ບ້ານ ແສນດິນ		
ລະຫັດໄປສະນີ ເຂດ 6: 01035		
ບ້ານບົວ	ບ້ານ ພັດທະນາ	ບ້ານ ສີວິໄລ	ບ້ານ ໂພນທອງ		
ບ້ານ ນາດີ	ບ້ານ ນາງ່າ	ບ້ານ ໂພນໄຊ	ບ້ານ ໂພສີ		
ບ້ານ ໜອງສະ	 	 	 		
ຫ້ອງການໄປສະນີ ດົງໂດກ 01040 - 01041		
ລະຫັດໄປສະນີ ເຂດ 1: 01040		
ບ້ານ ດົງໂດກ	ບ້ານ ໜອງພະຍາ	ບ້ານ ຄຳຮຸ່ງ	ບ້ານ ຈອມມະນີ		
ບ້ານ ຕານມີໄຊ	ບ້ານ ສີວິໄລ	ບ້ານ ຊ້າງຄູ່	 		
ບ້ານສະພັງມຶກ	ບ້ານ ພະຂາວ	ບ້ານ ສາຍນ້ຳເງີນ	 		
ລະຫັດໄປສະນີ ເຂດ 2: 01041		
ບ້ານວຽງແກ້ວ	ບ້ານ ຫ້ວຍເຕີຍ	ບ້ານ ຫ້ວຍແດນເມືອງ	ບ້ານ ສະພັງມຶກ		
ບ້ານ ໂນນແສງຈັນ	ບ້ານ ນາທົ່ມ	ບ້ານ ໜອງວຽງຄຳ	 		
ຫ້ອງການໄປສະນີ ດອນໜູນ 01050 - 01058		
ລະຫັດໄປສະນີ ເຂດ 1: 01050		
ສູນຫ້ວຍຍາງຫຼັກ 18	ບ້ານ ດອນໜູນ	ບ້ານ ໄຊ	ບ້ານ ດົງສ້າງຫີນ		
ບ້ານ ດົົງໝາກຄາຍ	ບ້ານ ດອນຕີ້ວ	ບ້ານ ນາແຄ	 		
ບ້ານ ດ່ານຊ້າງ	ບ້ານ ໄຊສະຫງ່າ	ບ້ານ ຫ້ວຍແດນເມືອງ	 		
ລະຫັດໄປສະນີ ເຂດ 2: 01051		
ບ້ານໂພຄໍາ	ບ້ານ ໂຄກໃຫຍ່	ບ້ານ ນາລ້ອມ	ບ້ານ ໂຄກສະອາດ		
ບ້ານ ໂຄກນ້ອຍ	ບ້ານ ສະພັງຄະນົງ	ບ້ານ ໜອງບົວ	ບ້ານ ທ່ານາກ		
ລະຫັດໄປສະນີ ເຂດ 3: 01052		
ບ້ານຫົວຊຽງ	ບ້ານ ໂນນທອງ	ບ້ານ ສົມສະຫວັນ	ບ້ານ ດອນລຸ່ມ		
ບ້ານ ດົງຄວາຍ	ບ້ານ ໄຜ່ລ້ອມ	ບ້ານ ໂຄກສະຫ່ວາງ	ບ້ານ ນາຜາສຸກ		
ບ້ານ ສ້າງຫົວບໍ່	ບ້ານ ສ້າງຄອນ	ບ້ານ ໂພນສະຫວັນ	ບ້ານ ບໍ່ເຫລັກ		
ລະຫັດໄປສະນີ ເຂດ 4: 01053		
ບ້ານນາມົນ	ບ້ານ ໂພນຕ້ອງ	ບ້ານ ນາແຖ່	ບ້ານ ທ່າດິນແດງເໜືອ		
ບ້ານ ດົງບັງ	ບ້ານ ທ່າດອກຄໍາ	ບ້ານ ໂພນງາມ 1	ບ້ານ ທ່າດິນແດງໃຕ້		
ບ້ານ ໂນນແຕ້	ບ້ານ ດວງບຸດດີ	ບ້ານ ໂພນງາມ 2	 		
ລະຫັດໄປສະນີ ເຂດ 5: 01054		
ບ້ານ ນາພອກ	ບ້ານ ເວີນແທ່ນ	ບ້ານ ນາຕານ	ບ້ານ ຫົວນາ		
ບ້ານ ປາກຊາບເກົ່າ	ບ້ານ ປາໄລ່	ບ້ານ ນາໂງ່ນໃໝ່	ບ້ານ ຫົວຂົວ		
ບ້ານ ປາກຊາບໃໝ່	ບ້ານ ດຸນອ່ຽນ	ບ້ານ ນາໂງ່ນເກົ່າ	ບ້ານ ໂພນແພງ		
ບ້ານ ແສນອຸດົມ	ບ້ານ ນາຂາວ	ບ້ານ ນາຄວາຍ	 		
ບ້ານ ສົມສະໃໝ	ບ້ານ ທ່າຈຳປາ	ບ້ານ ນາຄັນທຸງ	 		
ລະຫັດໄປສະນີ ເຂດ 6: 01055		
ບ້ານເພຍລາດ	ບ້ານ ທ່ານາຂາມ	ບ້ານ ປາກແຖບ	ບ້ານ ຫ້ວຍຫາງ		
ບ້ານ ຫີນລັບ	ບ້ານ ຫີນສິ່ວ	ບ້ານ ນາຕານ	ບ້ານ ຫ້ວຍຕົມ		
ບ້ານ ຫ້ວຍຄຳ	ບ້ານ ໄຮ່ໃຕ້	ບ້ານ ໃໝ່ປາກສັງ	 		
ບ້ານ ນາຫອຍ	ບ້ານ ນາສາວນາງ	ບ້ານ ຫ້ວຍລ້າ	 		
ລະຫັດໄປສະນີ ເຂດ 7: 01056		
ບ້ານໃຫຍ່ນາຈະເລີນ	ບ້ານ ນາປໍ	ບ້ານ ກົ້ວ	ບ້ານ ໄຮ່ເໜືອ		
ບ້ານ ໜອງບົວ	ບ້ານ ເຕົາໄຫ	ບ້ານ ນາຫອຍປັງ	 		
ລະຫັດໄປສະນີ ເຂດ 8: 01057		
ບ້ານ ສຳພັນນາ	ບ້ານ ດອນກາງຂອງ	ບ້ານ ສະໄກ	ບ້ານ ສະນ໋ອດ		
ບ້ານ ແກງໝໍ້	ບ້ານ ປາກຕອນ	ບ້ານ ອ່າງນ້ອຍ	ບ້ານ ທ່ານາສາ		
ບ້ານ ທ່ານາສ້າງຫີນ	ບ້ານ ໂຄກເພີງ	ບ້ານ ໂຄກແຫ້	 		
ຫ້ອງການໄປສະນີ ທ່າງ່ອນ 01060- 01061		
ລະຫັດໄປສະນີ ເຂດ 1: 01060		
ບ້ານໂພນສະອາດ	ບ້ານ ນາ	ບ້ານ ແກ້ງໄຄ້	ບ້ານ ສາມສະອາດ		
ບ້ານ ອຸດົມຜົນ	ບ້ານ ໂນນບໍ່ແກ້ວ	ບ້ານ ທ່າສົ້ມມໍ	ບ້ານ ໂພນໄຊ		
ບ້ານ ລາດຄວາຍ	ບ້ານ ທ່າງ່ອນ	ບ້ານ ທ່າສະຫວ່າງ	ບ້ານ ໂພນງາມ		
ບ້ານ ໂພນຄໍ້	ບ້ານ ພູຄຳ	ບ້ານ ເວີນຄຳ	ບ້ານ ໜອງເຂັງ		
ລະຫັດໄປສະນີ ເຂດ 2: 01061		
ບ້ານ ໜອງໂນ	ບ້ານ ໂພນໂຮງ	ບ້ານ ຊຳບອນ	ບ້ານ ນາຕານ		
ບ້ານ ໄຮ່	ບ້ານ ນາງາມ(ໃໝ່)	ບ້ານ ທົ່ງມັ່ງ	ບ້ານ ຫົວຂົວ		
ບ້ານ ໂພນໄຮ່ຄຳ	ບ້ານ ໂພນຄໍ້	ບ້ານ ທ່າພະອິນ	ບ້ານ ຫົວນາ		
ບ້ານ ຫາດກ້ຽງ	ບ້ານ ນາກຸງ	ບ້ານ ນາງາມ (ເກົ່າ)	 		
ຫ້ອງການໄປສະນີ ໄຊເສດຖາ 01070 - 01074		
ລະຫັດໄປສະນີ ເຂດ 1: 01070		
ບ້ານທາດຫລວງເໜືອ	ບ້ານ ທາດຫຼວງໃຕ້	ບ້ານ ໂພນເຄັງ	ບ້ານ ໂພນພະເນົາ		
ບ້ານ ທາດຫຼວງກາງ	ບ້ານ ວຽງຈະເລີນ		 		
ລະຫັດໄປສະນີ ເຂດ 2: 01071		
ບ້ານຮ່ອງແກ	ບ້ານ ໂພນທັນໃຕ້	ບ້ານ ສະພັງໝໍ້	ເຂດພິເສດບຶງທາດຫລວງ		
ບ້ານ ໂພນທັນເໜືອ	 	 	 		
ລະຫັດໄປສະນີ ເຂດ 3: 01072		
ບ້ານຄຳສະຫວາດ	ບ້ານ ຫົວຂົວ	ບ້ານ ໂນນຄໍ້ເໜືອ	ບ້ານ ນາຄວາຍເໜືອ		
ບ້ານ ໂນນຫວາຍ	ບ້ານ ໂນນຄໍ້ໃຕ້	ບ້ານ ສົມສະຫງ່າ	ບ້ານ ນາຄວາຍໃຕ້		
ລະຫັດໄປສະນີ ເຂດ 4: 01073		
ບ້ານໂນນສະຫວ່າງ	ບ້ານ ວັງຊາຍ	ບ້ານ ໂນນສະຫວັນ	ບ້ານ ຮ່ອງສຸພາບ		
ບ້ານ ໂຊກຄຳ	ບ້ານ ໂນນສະຫງ່າ	ບ້ານ ອາມອນ	ບ້ານ ໜອງໜ່ຽງ		
ລະຫັດໄປສະນີ ເຂດ 5: 01074		
ບ້ານ ແສງສະຫວ່າງ	ບ້ານ ຊຳເຄ້	ບ້ານ ໂຊກໃຫຍ່	ບ້ານ ນາບຽນ		
ບ້ານ ຂາມງອຍ	ບ້ານ ໂຊກນ້ອຍ	ບ້ານ ດຸງ	ບ້ານ ໂພນທອງ		
ຫ້ອງການໄປສະນີ ຈີນາຍໂມ້ 01080 - 01082		
ລະຫັດໄປສະນີ ເຂດ 1: 01080		
ບ້ານພັນໝັ້ນ	ບ້ານ ດອນປ່າໃໝ່	ບ້ານ ຈອມແຈ້ງ	ບ້ານ ຈອມເພັດເໜືອ		
ບ້ານ ວັດສົບ	ບ້ານ ສ້າງເຫວີຍ	ບ້ານ ໂຄກນີນ	ບ້ານ ຈອມເພັດໃຕ້		
ບ້ານ ໂພໄຊ	ບ້ານ ດົງສະຫວາດ	ບ້ານ ໄຊສະຖານ	 		
ບ້ານ ສວນມອນ	ບ້ານ ຫາຍໂສກ	ບ້ານ ໂພນສະຫວ່າງ	 		
ລະຫັດໄປສະນີ ເຂດ 2: 01081		
ບ້ານຫາດຊາຍຂາວ	ບ້ານ ສົມສະໜຸກ	ບ້ານ ສາລະຄຳເໜືອ	ບ້ານ ດອນຝ້າຍ		
ບ້ານ ສົມຫວັງເໜືອ	ບ້ານ ໜອງໄຮ	ບ້ານ ສາລະຄຳໃຕ້	ບ້ານ ດົງ		
ບ້ານ ສົມຫວັງໃຕ້	ບ້ານ ໜອງແວງ	ບ້ານ ດົງໂພນເລົາ	 		
ລະຫັດໄປສະນີ ເຂດ 3: 01082		
ບ້ານທ່ານາ	ບ້ານ ພ້າວ	ບ້ານ ຫາດດອກແກ້ວ	ບ້ານ ແກ້ງປາຢ້າງ		
ບ້ານ ບໍ່ໂອ	ບ້ານ ແກ້ງຍາງ	ບ້ານ ດອນຂາຊາຍ	ບ້ານ ດອນດູ່		
ບ້ານ ກາງທົ່ງ-ກາງທ່າ	ບ້ານ ສົມໂຮງ	ບ້ານ ນາທາມ	 		
ຫ້ອງການໄປສະນີ ບ້ານຫ້ອມ 01090		
ບ້ານສີຖານໃຕ້	ບ້ານ ທ່າແຂກ	ບ້ານ ຫົວຫ້າ	ບ້ານ ຫ້ອມໃຕ້		
ບ້ານ ໂຄກຊາຍ	ບ້ານ ສະຫວ່າງ	ບ້ານ ຫາດກັນຊາ	ບ້ານ ຈຽມປາງ		
ບ້ານ ຊາຍຟອງໃຕ້	ບ້ານ ໂພສີ	ບ້ານ ປ່າຝາງ	ບ້ານ ຖີ່ນເພຍ		
ບ້ານ ຊາຍຟອງເໜືອ	ບ້ານ ໂພເງິນ	ບ້ານ ຈອມທອງ	 		
ຫ້ອງການໄປສະນີ ທ່ານາແລ້ງ 01100		
ດ່ານພາສີ	ສູນດາວທຽມ	ບໍລິສັດ ໄຕລອນ	 		
ດ່ານກວດຄົນເຂົ້າ-ອອກເມືອງ	ນໍ້າມັນລາວ	ບໍລິສັດ ເອັກພີເອັກ XPX	 		
ສູນແມ່ຍິງພິການ	ບໍລິສັດ ດາວເຮືອງ	ບໍລິສັດ ພີເອັສບີ PSB	 		
ຫ້ອງການໄປສະນີ ທ່າເດື່ອ 01110		
ບ້ານ ປ່າຫວ້າ	ບ້ານ ໜອງແປນໃຕ້	ບ້ານ ທ່າພະ	ບ້ານ ຄວາຍແດງ		
ບ້ານ ທ່າເດື່ອ	ບ້ານ ໜອງແປນເໜືອ	ບ້ານ ປາກເປັ່ງ	ບ້ານ ນາລ້ອງ		
ບ້ານ ຖີ່ນຕົມ	ບ້ານ ນ້ອຍຈະເລີນຄໍາ	ບ້ານ ຖີ່ນແທ່ນ	ບ້ານ ໜອງພົງ		
ບ້ານ ທ່າມ່ວງ	ບ້ານ ດົງໂພສີ	ບ້ານ ນາໄຮ່	ບ້ານ ດົງຄຳຊ້າງ		
ບ້ານ ທ່ານາແລ້ງ	ບ້ານ ໜອງແຫ້ວ	ບ້ານ ນາໄຫ	ບ້ານ ດົງໂພນແຮ		
ບ້ານ ຊຽງຄວນ	ບ້ານ ໂພນບົກ	ບ້ານ ສີມມະໂນ	 		
ຫ້ອງການໄປສະນີ ເມືອງສັງທອງ 01120 - 01122		
ລະຫັດໄປສະນີ ເຂດ 1: 01120		
ບ້ານເພຍລາດ	ບ້ານ ນາຫອຍ	ບ້ານ ຫີນສີ່ວ	ບ້ານ ນາສາວນາງ		
ບ້ານ ຫີນລັບ	ບ້ານ ທ່ານາຂາມ	ບ້ານ ໄຮ່ໃຕ້	ບ້ານ ປາກແຖບ		
ບ້ານ ຫ້ວຍຄຳ	 	 	 		
ລະຫັດໄປສະນີ ເຂດ 2: 01121		
ບ້ານສຳພັນນາ	ບ້ານ ປາກຕອນ	ບ້ານ ໂຄກແທ້	ບ້ານ ຫ້ວຍລາ		
ບ້ານ ແກ້ງໝໍ້	ບ້ານ ໂຄກເຜີ້ງ	ບ້ານ ສະນ໋ອດ	ບ້ານ ຫ້ວຍຫາງ		
ບ້ານ ທ່ານາສ້າງຫີນ	ບ້ານ ສະໄກ	ບ້ານ ທ່ານາສາ	ບ້ານ ຫ້ວຍຕົມ		
ບ້ານ ດອນກາງຂອງ	ບ້ານ ອ່າງນ້ອຍ	ບ້ານ ໃໝ່ປາກສັງ	 		
ລະຫັດໄປສະນີ ເຂດ 3: 01122		
ບ້ານໃຫຍ່ນາຈະເລີນ	ບ້ານ ນາປໍ	ບ້ານ ກົ້ວ	ບ້ານ ໄຮ່ເໜືອ		
ບ້ານ ໜອງບົວ	ບ້ານ ເຕົາໄຫ	ບ້ານ ນາຫອຍປັງ	 		
ຫ້ອງການໄປສະນີ ເມືອງປາກງື່ມ 01130 - 01135		
ລະຫັດໄປສະນີ ເຂດ 1: 01130		
ບ້ານສົມສະຫວາດ	ບ້ານ ສົມປະເສີດ	ບ້ານ ປາກງື່ມ	ບ້ານ ຝັງແດງ		
ບ້ານ ໄຮ່	ບ້ານ ເວີນແຄນ	ບ້ານ ໜອງຂຽດ	 		
ລະຫັດໄປສະນີ ເຂດ 2: 01131		
ບ້ານນາທາມ	ບ້ານ ໂນນສູງ	ບ້ານ ໜອງພູວຽງ	ບ້ານ ປາກກວາງ		
ບ້ານ ນາຊອນ	ບ້ານ ນາເລີດ	ບ້ານ ພ້າວ	 		
ລະຫັດໄປສະນີ ເຂດ 3: 01132		
ບ້ານໂດນເໜືອ	ບ້ານ ນາກຸງ	ບ້ານ ທ່າກອກ	ບ້ານ ດອນແຍງ		
ບ້ານ ໂດນໃຕ້	ບ້ານ ທຸນລົວ	ບ້ານ ໂນນຊາຍ	ບ້ານ ດອນສັງຄີ		
ລະຫັດໄປສະນີ ເຂດ 4: 01133		
ບ້ານໝາກນາວດົງ	ບ້ານ ໝາກຮຽວ	ບ້ານ ດົງສານ	ບ້ານ ໜອງວັງເຜິ້ງ		
ບ້ານ ໝາກນາວເໜືອ	ບ້ານ ດອນວັງໂພ	ບ້ານ ທ່າເດື່ອສິງຫອມ	 		
ບ້ານ ໝາກນາວໃຕ້	ບ້ານ ດົງກະລືມ	ບ້ານ ຖິ່ນທ່ຽງ	 		
ລະຫັດໄປສະນີ ເຂດ 5: 01134		
ບ້ານນາຝາຍ	ບ້ານ ໂຄກສາ	ບ້ານ ໂນນສົມບູນ	ບ້ານ ໜອງແຄນ		
ບ້ານ ສາງໃສ	ບ້ານ ດອນໄຮ່	ບ້ານ ດອນສ້າງໄພ	ບ້ານ ຫ້ວຍນ້ຳຍຸນ		
ບ້ານ ໜອງບົວທອງ	ບ້ານ ນາຊາ	 	 		
ລະຫັດໄປສະນີ ເຂດ 6: 01135		
ບ້ານທ່າກົກໄຮ	ບ້ານ ຊຽງແລທ່າ	ບ້ານ ນາບົງ	ບ້ານ ໜອງດົງ		
ບ້ານ ທ່າຊ້າງ	ບ້ານ ຊຽງແລນາ	ບ້ານ ໂພນຂາມ	 		
ບ້ານ ໂນນ	ບ້ານ ເວີນກະເບົາ	ບ້ານ ຫົວນາ	 		
ແຂວງ ຜົ້ງສາລີ
ເລກລະຫັດໄປສະນີ 02000
ແຂວງ ຜົ້ງສາລີ  02xxx			
ເມືອງ ຜົ້ງສາລີລະຫັດໄປສະນີ 02000 - 02003 			
ລະຫັດໄປສະນີ ເຂດ 1: 02000			
ບ້ານຜົ້ງສາລີ	ບ້ານ ພູຟ້າ	ບ້ານ ໂພນແກ້ວ	ບ້ານ ຈັນຕານ	 		
ບ້ານ ຈອມເມືອງ	ບ້ານ ສາຍລົມ	ບ້ານ ໂພນສະອາດ	ບ້ານ ຂຸນໜຸ່ມນ້ອຍ	 		
ບ້ານ ຕະຫຼາດວິໄລ	ບ້ານ ໜອງກີນນະລີ	ບ້ານ ຮົ່ມສະຫວ່າງ	ບ້ານ ຂຸນໜຸ່ມຫຼວງ	 		
ບ້ານ ວັດແກ້ວ	ບ້ານ ແສນສະລີ	ບ້ານ ມົງເຈົາ	ບ້ານ ບໍກົ້ງ	 		
ລະຫັດໄປສະນີ ເຂດ 2: 02001	 		
ບ້ານ ຢາປຸງ	ບ້ານ ສາລາເອເບ	ບ້ານ ຫາດສາ	ບ້ານ ສົມບຸນ	 		
ບ້ານ ນ້ຳປຸງ	ບ້ານ ບາການ້ອຍ	ບ້ານ ປາງຊໍ່	ບ້ານ ໂພນໂຮມ	 		
ບ້ານ ຈີ໋ໂຈະ	ບ້ານ ຜ່າປຸ່ນ	ບ້ານ ວັງໄຊ	ບ້ານ ພູຊຸມໃຕ້	 		
ບ້ານ ບາກາຫຼວງ	ບ້ານ ສາມັກຄີໄຊ	ບ້ານ ນ້ຳສາ	ບ້ານ ນ້ຳແລ້ງ	 		
ລະຫັດໄປສະນີ ເຂດ 3: 02002	 		
ບ້ານ ຈ່າພູ	ບ້ານ ຜົ້ງແຊັກ	ບ້ານ ຫ້ວຍລູ	ບ້ານ ເລົ່າຟູຈ້າຍ	 		
ບ້ານ ກໍແດງ	ບ້ານ ຫ້ວຍຊືນ	ບ້ານ ນ້ຳອົ້ງ	ບ້ານ ໂຮມສ້າງ	 		
ບ້ານ ລຸ່ງຈີ້ງ	ບ້ານ ພູດອກຈຳ	ບ້ານ ອຸດົມ	ບ້ານ ພູຍອດ	 		
ບ້ານ ພະຍາສີ	ບ້ານ ກີ້ວ	ບ້ານ ຮວງຕ້າເຢ	ບ້ານ ແຊວຈ້າຍໃໝ່+ເກົ່າ	 		
ລະຫັດໄປສະນີ ເຂດ 4: 02003	 		
ບ້ານ ໂລ່ງຊ່າງ	ບ້ານ ຈາຄຳປາ	ບ້ານ ເລົ້າແທນ	ບ້ານ ຫາດຫີນ	 		
ບ້ານ ປາຍໂຈ	ບ້ານ ງາຍໃຕ້	ບ້ານ ເລົ້າຕ່ຽວ	ບ້ານ ຕາຕຸງ	 		
ບ້ານ ນ້າໂປຊ່າງເກົ່າ	ບ້ານ ສີ້ນຈ້າຍ	ບ້ານ ສຳເມືອງຫຼວງ	ບ້ານ ຈະເລີນ	 		
ບ້ານເປີເຢັນຊ່າງເກົ່າ	ບ້ານ ຕ້າແສນຜົ້ງ	ບ້ານ ສົບງາມ	ບ້ານ ສົບກັ້ງ	 		
ບ້ານເປີເຢັນຊ່າງໃໝ່	ບ້ານ ຢາວຟາງ	ບ້ານ ຈັງເຕີນ+ນ້ຳປືນ	 	 		
ເມືອງຂົວ ລະຫັດໄປສະນີ 02010 - 02015			
ລະຫັດໄປສະນີ ເຂດ 1: 02010			
ບ້ານເມືອງຂວາ	ບ້ານ ສະຫຼອງໄຊ	ບ້ານ ໂພໄຊເໜືອ + ຫາດອາຍ	ບ້ານ ບວມພັນ			
ບ້ານ ສົບອັດ	ບ້ານ ຫາດເດືອ	ບ້ານ ໂພນໄຊ	ບ້ານ ກົກພ້າວ			
ບ້ານ ຫ້ວຍຍ່າງ	ບ້ານ ໂພໄຊໃຕ້	ບ້ານ ຫ້ອຍກຸດ	ບ້ານ ຮອງເລີກ			
ບ້ານ ນາຕຸ່ນ+ຈະລີ	ບ້ານ ທ່າບັກ	ບ້ານ ພິເຈິໃໝ່	ບ້ານ ພິເຈີເກົ່າ			
ລະຫັດໄປສະນີ ເຂດ 2: 02011			
ບ້ານ ແສນຄຳເໜືອ	ບ້ານ ນ້ຳມາເໜືອ	ບ້ານ ຫາດນາງ	ບ້ານ ດົງຂາມ			
ບ້ານ ກົກງີ້ວ	ບ້ານ ປູລຸ	ບ້ານ ສີນໄຊ	ບ້ານ ຫ້ວຍພອດ			
ບ້ານ ຫ້ວຍຫຼາ	ບ້ານ ມົກກວາງ	ບ້ານ ລາວວີ	ບ້ານ ສັນຫຼວງ			
ບ້ານ ນ້ຳມາໃຕ້	ບ້ານ ພູສະຖີ	ບ້ານ ແສນຄຳໃຕ້	ບ້ານ ຫ້ວຍແພກໍ່			
ລະຫັດໄປສະນີ ເຂດ 3: 02012			
Ban Leesou 	Ban Huayleek 	Ban Huaysalaeng 	Ban Phonsa-ard			
Ban Huayphae-aou 	Ban Huaysoy 	Ban SaenLard 	Ban Yangtei			
Ban Pakban 	Ban Huayphouk 	Ban Koungkueay 	Ban Aom thap 			
Ban Tangkok 	Ban Aomloung 	Ban Aomphia 	Ban Na 			
ລະຫັດໄປສະນີ ເຂດ 4: 02013			
Ban Nambouth 	Ban Huaykhang 	Ban Lardxang 	Ban Huaypa 			
Ban Viengkham 	Ban Mai 	Ban Monesavanh 	Ban Sopkaiy 			
Ban Aomphrou 	Ban Kiw 	Ban Hadsei 	Ban Huaymone 			
Ban Chanmai 	Ban Sanghuay+ Phia 	Ban Choukkouth 	Ban Lahangyai 			
ລະຫັດໄປສະນີ ເຂດ 5: 02014			
Ban Nambone tai 	Ban Chalamai 	Ban Yahloh 	Ban Kiwkam 			
Ban Nambone nuea 	Ban Tangkala 	Ban Huayaone	Ban Kiwthark 			
Ban Samamchaep 	Ban Chalakao 	Kokngiw+Lahangnoy 	Ban Aomtala 			
Ban Sabor 	Ban Tonechong 	Ban Saenyang 	Ban Kongvat 			
ລະຫັດໄປສະນີ ເຂດ 6: 02015			
Ban Dupkachork 	Ban Mokphaek 	Ban Hadpon 	Ban Kadueng 			
Ban Phuvieng 	Ban Kounglith 	Ban Vangkong	Ban Viengxay 			
Ban Keo luang 	Ban Tanhah 	Ban Aomtuen 	Ban Kongbrang 			
Ban Huay thong 	Ban Haddaen 	 	 			
ເມືອງສໍາພັນ ລະຫັດໄປສະນີ 02020 - 02023			
ລະຫັດໄປສະນີ ເຂດ 1: 02020			
Ban Naxay 	Ban Phouxay 	Ban Khanar	Ban Mok-koknoy 			
Ban Na+Hadlan 	Ban Aomtham 	Ban Namly 	Ban Phieng 			
Ban Natei 	Ban Huaythong 	Ban Mok-kokluang 	Ban Laxakao 			
Ban Yangnuea 	Ban Thaovong 	Ban Phouvieng 	Ban Donchan 			
ລະຫັດໄປສະນີ ເຂດ 2: 02021			
Ban Mokpha 	Ban Saenluangmai 	Ban Namhang 	Ban Namhoun 			
Ban Aielek 	Ban Sanamhah 	Ban Namaon+Moklom 	Saengdaohueang 			
Ban Axer 	Ban Leeway 	Ban Namyuan+Santan 	Ban Sylatherng 			
Ban Phialuang 	Ban Naaou 	Ban Nongkham 	Ban Sopkheek 			
ລະຫັດໄປສະນີ ເຂດ 3: 02022			
Ban Namthuang 	Ban Phongku 	Ban Mouchikao 	Ban Mokyon 			
Ban Laopan 2	Ban Mouchikang 	Ban Laosaen 	Ban Namloy 			
Ban Kongsavee 	Ban Phouxang kao 	Ban Somboun 	Ban Kongkhoum 			
Ban Laopan 1 	Ban Phouxang mai 	Ban Xakeo 	Ban Laolell			
ລະຫັດໄປສະນີ ເຂດ 4: 02023			
Ban Namnga 	Ban Nonghoum 	Ban Erpa 	Ban Nongkeo 			
Ban Tangchark 	Ban Chaphiwnoy	Ban Kokmuang	Ban Saenkham 			
Ban Hadnganuea 	Ban Leexezo 	Ban Chaxue 	Ban Xiengnuea 			
Ban Hadngatai 	Ban Chaphiwluang 	Ban Kherchangkao 	Ban Namkee 			
Ban Yangpa 	 	 	 			
ເມືອງ ໃໝ່ ລະຫັດໄປສະນີ 02030 - 02033 			
ລະຫັດໄປສະນີ ເຂດ 1: 02030			
Ban Nazong 	Ban Huayzongnuea+
Ban Xangkhaen 	Ban Aompalong 	Ban Sopnaow 			
Ban Namnga 	Ban Huayvangkao 	Ban Poungkhao 	Ban Huayphouk 			
Ban Nakang 	Mokchala-Homxay 	Ban Aomkaneng 	Ban Huaycha 			
Ban Saenard+ Huayzongtai 	Ban Huayvangmai	Ban Huaylord+Poungnok 	Ban Panghok+
Ban Huaychoung 			
Ban Nakham 	Ban Huayvangsouth 	Ban Noy 	 			
Ban Huaychik 	Ban Huayaoun 	Ban Sophoun 	 			
ລະຫັດໄປສະນີ ເຂດ 2: 02031			
Ban Huaydoy 	Ban Yakha 	Paklaeng-Lahang 	Ban Haddy 			
Ban Naluang-Aomtou 	Ban Phia 	Ban Saenngern-Kounghah 	Ban Poung 			
Ban Buamphan 	Ban SaenAin 	Ban Poungyang 	Ban Pakphae 			
Ban Huaykang 	Ban Aomphalou 	Ban Tahmoh 	Pakyuan+koksom 			
Koungloung-Kokngiw 	Ban Saenluang 	Ban Seeda+Huayyam 	 			
Kiwkajum-Mokkaark 	Ban Yayoung 	Ban Hadcha 	 			
ລະຫັດໄປສະນີ ເຂດ 3: 02032			
Ban Yangtai 	Ban Tangzoiy 	Teentok+Pongsykao 	Ban Huaythong 			
Ban Soungloung 	Ban Phialorkao 	Ban Kiwkalaeh	Ban Phiengluang+
Nonglom 			
Ban Panghaitai 	Ban Zaoyang 	Ban Palan	Ban Huayhong+
Huaydaeng 			
Ban Panghainuea+
Parkvieng 	Ban Phialormai 	Ban Namkhong 	Ban phonxay 			
Ban Chabue 	Ban Moutern 	Ban Huayngei 	 			
Ban Chamei 	Ban Pongseemai 	Ban Laomakang+
Kaohuayphouk 	 			
ລະຫັດໄປສະນີ ເຂດ 4: 02033			
Ban Saenta,
Phouyang ,Huangor 	Ban Kharchee 	Ban Saluang-Nongheo 	Ban Nalam			
Ban Huaymin-Buamyao 	Ban Huayant-
Thaengluang 	Ban Huaykop 	Ban Maikorliw 			
Ban Nabua-Kangsan 	Ban Nalae 	Ban Nakhua 	Ban Huayla 			
Ban Phuentee+
Huayphouk 	Ban Maiduea 	Ban Huayhia 	Ban Huaylaiy-pakpa 			
Ban Chomcheokao (Xaeng) 	Ban Sompoy 	Ban Kang (Huana) 	 			
Ban Chomcheomai 	Ban Namnaen 	Ban Finhor 	 			
ເມືອງ ບຸນເໜືອ ລະຫັດໄປສະນີ 02040 - 02043 			
ລະຫັດນີ ເຂດ 1: 02040			
Phiengdorkkham 	Ban Kong 	Bban ormang 	Ban Bounphieng 			
Ban Bounnuea 	Ban Huaylek 	Ban Phapounkao	Ban Nambounkao 			
Ban Bounfueang	Ban Bormai 	Ban Saentham 	Ban Saenxay 			
Ban Nalae 	Ban Namyongmai 	Ban Sinxay 	Ban Mai 			
ລະຫັດໄປສະນີ ເຂດ 2: 02041			
Ban Nonsawang 	Ban Napoc	Ban Xiengfar 	Ban Huaylo 			
Ban Thonghueabin 	Ban Phonhom 	Ban Phiengxay 	Ban Yordboun 			
Ban Dernkila 	Ban Phonxay 	Ban Noy-Phoumang 	Ban Huayzang 			
Ban Huaydong 	Ban Hom 	Ban Dongnuea 	Ban Morzorsan 			
ລະຫັດໄປສະນີ ເຂດ 3: 02042			
Ban Khaemkor	Panghok-Sopkhing 	Namkung-Namhue	Ban Vangdoy			
Ban Mailongthong 	Ban Saendaotai 	Ban hadaeng-Saendaonuea 	Ban Namphae 			
Ban Ngaiynuea 	Ban Apaerkhor	Ban Phouza 	Ban Huaykat 			
Ban Huayying 	Ban Namyongkao 	Ban Donexaiy 	Ban Huaypong 			
ລະຫັດໄປສະນີ ເຂດ 4: 02043			
Ban Huaylae 	Ban Somboun 	Ban Huaytou 	Ban Huakhua73 			
Ban Bounxang 	Ban Huaysoung 	Ban Namlu 69 	Ban Borkhoun 			
Ban Yor 	Ban Namhoy 	Ban Phiachen 70 	Ban Huaytat 78 			
Ban Duea 	Ban Huakha 66 	Ban Pakhamai 68 	Ban Pakhakao 79 			
Ban Xiengpee 			 			
ເມືອງ ບຸນໃຕ້ ລະຫັດໄປສະນີ 02050 - 02053  			
ລະຫັດໄປສະນີ ເຂດ 1: 02050			
Ban Phothong 	Ban Nawaii 	Ban Xingxay 	Ban Aya 			
Ban Bountai 	Ban Bounyong	Ban Namlannoy 	Ban Chulaosaen- kao 			
Ban Nonbounkang 	Ban Naxay 	Ban Huaykhong 	Ban Chulaosaen- mai 			
Ban Saen-inmai 	Ban Phialek 	Ban Sanoyai	Ban Sanarmyangpa 			
ລະຫັດໄປສະນີ ເຂດ 2: 02051 			
Ban Namkuangkao 	Phiasou+Namkhoun 	Phongkounamkuang 	Moucheehuaysan 			
Ban Pouleekao 	Ban Chamaer 	Kokkhornoy+Nammang	Ban Aneng 			
Ban Sanokao 	Ban Hadngam 	Ban Namark 	Ban Huaywaii 			
Chahor+Huayaor 	Ban Hadset	Ban Namkhounmai 	Ban Namheen 			
ລະຫັດໄປສະນີ ເຂດ 3: 02052			
Ban Namban 	Ban Borhad+Chovang 	Ban Phiwcher 	Ban Chakhamzao 			
Ban Chaluangmai 	Ban Bornoy 	Ban Pangkai 	Ban Moutuen 			
Ban Longnaiy kao 	Ban Laoku kao 	Ban Nataen 	Ban Sapa 			
Ban Longnaiy mai 	Ban Laoku mai 	Ban Chaluanglee 	Chakhamdaeng 			
ລະຫັດໄປສະນີ ເຂດ 4: 02053			
Ban Thaoduang 	Ban Terka 	Ban Saen-inluang 	Ban Longthang+
Phoumone			
Ban Sanonamlan 	Ban Cherya 	Ban Pouleemai 	Ban xengkangkao
+mai 			
Ban Samphanxay 	Ban Eperching 	Ban Aichonampok 	Ban Nanam 			
Ban Kaosan 	Ban Chakhamlue+Icho 	Ban Aicheenampok 	Ban Phoukhor 			
ເມືອງ ຍອດອູ ລະຫັດໄປສະນີ 02060 - 02064   			
ລະຫັດໄປສະນີ ເຂດ 1: 02060			
Ban Therng 	Ban Tai	Ban Khueanuea 	Ban Panghok 			
Ban Loum 	Ban Phanthong 	Ban Soumkham 	Ban Voupaokang 			
Ban Kard 	Ban Chomphor 	Ban Tang 	Ban Tapersu 			
Ban Phouxang 	Ban Somxay 	Ban Huayaou 	Ban Sawang 			
ລະຫັດໄປສະນີ ເຂດ 2: 02061			
Ban Chokamai 	Ban Nakong 	Ban Phiengsaeng 	Ban Suayngam 			
Ban Chokakao 	Ban Phor 	Ban Borxao 	Ban Zeochaiy 			
Ban Nayaow 	Ban Sinchaiy 	Ban Huayxaiy 	Ban Somhueang 			
Ban Bortai 	Ban Takouxang 	Ban Phonngam 	Ban Xiengziew 			
ລະຫັດໄປສະນີ ເຂດ 3: 02062			
Ban Nammar 	Ban Leesanmor 	Ban Taleesu 	Ban Naluang 			
Ban Longthang 	Ban Lantoui 	Ban Zeoleesu 	Toungkualin noy 			
Ban Yordnamaou 	Ban Koungchee 	Ban Phinchang 	Ban Kang 			
Ban Huaypaenuea 	Ban Voupaonuea 	Ban Laomeo 	Toungkualin yai 			
ລະຫັດໄປສະນີ ເຂດ 4: 02063			
Ban Phungsan 	Ban Phadaeng 	Ban Huayka 	Ban Peryinxang			
Ban Huayva 	Ban Mexay 	Ban Yeniwtoung 	Ban Perhuasu 			
Ban Pacha 	Ban Chansan 	Ban Malytho 	Xeethongpakao 			
Ban Phounueasan 	Ban Yakher 	Ban Nahok 	Xeethongpamai 			
ລະຫັດໄປສະນີ ເຂດ 5: 02064			
Thouchangfang 	Ban Xeekaohoh 	Ban Huayyoum 	Ban Xeohopaen 			
Maengkuaphong 	Ban Lar 	Ban Nammarnoy 	Ban Perlaovou 			
Ban Seevilay 	Ban Kaeng 	Ban Soulin 	Ban Aounuea 			
Xeeperchaiy 	Ban Ngong 	Ban Nammaryai 	 			






ແຂວງ ຫລວງນໍ້າທາ
ເລກລະຫັດໄປສະນີ 03000
ແຂວງຫລວງນໍ້າທາ  03xxx					
ເມືອງ ຫລວງນໍ້າທາ ລະຫັດໄປສະນີ 03000 - 03002					
ລະຫັດໄປສະນີ ເຂດ 1: 03001					
Ban Aoudomsin 	Ban Thongchaitai 	Ban Huakhua 	Ban Viengngern 					
Ban Phonxay	Thongchainuea 	Ban Viengkham 	Ban Namchang 					
Ban Nahom 	Ban ThongAom 	Ban Donesamphan 	Ban Nongbuavieng 					
Ban Viengthong 	Ban Hadyaow	Ban Thongdee 	Ban Parpuah 					
ລະຫັດໄປສະນີ ເຂດ 2: 03002					
Ban Huana 	Ban Thongkhua 	Ban Mai 	Ban ThaAor 					
Ban Namdee 	Ban Namngaen 	Ban Donelae 	Ban Nalue 					
Ban Namthoung 	Phonxaysawang 	Ban Donemoun 	Ban Nanoy 					
Ban Viengtai 	Ban Poung 	Ban Donekhoun 	Ban Namsar 					
Ban Viengnuea 	Ban Parsak 	Ban Luang 	Ban Namhar 					
Ban Khone 	Ban Khuasoung 	Ban Namlue 	Ban Pahlang 					
ລະຫັດໄປສະນີ ເຂດ 3: 03002					
Ban Tarwan 	Namdaengtai 	Ban Natei 	Ban borten 					
Ban Kokmee 	Ban Suanya 	Ban Teentok 	Ban Namloung 					
Namdaengnuea 	Ban Pangsa 	Ban Borkuea 	Ban Bomphien 					
ເມືອງ ສິງ ລະຫັດໄປສະນີ  03010 - 03012					
ລະຫັດໄປສະນີ ເຂດ 1: 03010					
Ban Xiengyuen 	Ban Donepoy 	Ban Singchalern 	Ban Thongyon 					
Ban Xiengchai	Ban Donemai 	Ban Silihueang 	Ban kangmai 					
Ban Xienglae 	Ban Donechai 	Ban Tarpaow	Ban Nakham 					
Ban Xiengain 	Ban Nongkham 	Ban Namkeoluang 	Ban Sor 					
Ban Xiengmoun 	Ban Nongbua 	Ban Thaongmai 	Ban Silimon					
Ban Huakhua 	Ban Kokmuang 	Ban Aoudomsin 	 					
ລະຫັດໄປສະນີ ເຂດ 2: 03011					
Ban Phabath 	Ban Donethan 	Ban Huanakang 	Ban Koum 					
Ban Chom 	Ban Pakha 	Ban Namlek 	Ban Parpoiy					
Ban phayaluang 	Ban Namdaiy 	Ban Huana 	Ban Huakhua 					
Ban Paxang 	Singphatthana 	Ban Teenthad 	Ban Mai 					
Ban Nammaiy 	Ban Huananuea 	Ban Namkeonoy 	Ban Yangluang 					
ລະຫັດໄປສະນີ ເຂດ 3: 03012					
Ban Chongka	Namdaedsomboun 	Ban Siw 	Ban Mocna 					
Ban Huaykod 	Huaykhaem 	Ban Sueadaeng 	Ban Sopemai 					
Ban Laokhao	Pakhavaii 	Ban Naxay 	 					
Ban Huayla 	Tanee 	Ban Pheeyer 	 					
Ban Huayhoy 	Erwar 	Ban Laowsee 	 					
ເມືອງ ນາແລ ລະຫັດໄປສະນີ  03020 - 03021					
ລະຫັດໄປສະນີ ເຂດ 1: 03020					
Ban Vangmexay 	Ban Viengmai 	Ban Nayaeng 	Ban Nongkham 					
Ban Aorm 	Ban Phouthon 	Ban Phoupard 	Ban Sacan 					
Ban Phoula 	Ban Nalae 	Ban Hadtoc	Ban Houn 					
Ban Nongpasaed 	Ban khonekham 	Ban Hadloy 	Ban Phoukhang 					
Ban Laoh 	Ban Ngouan 	Ban Tongthone 	Ban Khonethip 					
Ban Phouchalae 	Ban Kahbeh 	Ban Vaen 	Ban Tahkherng 					
Ban Pherng 	Ban Taloui 	Ban Phangboke 	Ban Chomsee 					
Ban Phoukha 	Ban Phoutan 	Ban Hadtaeh 	Ban Kiwhinxang 					
ລະຫັດໄປສະນີ ເຂດ 2: 03021		
Ban Khonechan 	Ban Vard 	Ban Donexaiy 	Ban Mokkoud 					
Ban Hadnalaeng 	Ban Mokphad 	Ban Sangark 	Ban Mokjord 					
Ban Phouluang 	Ban Konelang 	Ban Hadchala 	Ban Kunhah 					
Ban Saloiy 	Ban Puean 	Ban Hadlom 	Ban Hadhup 					
Ban Namhaeng 	Ban Sakup 	Ban Phouvieng 	Ban Phoulom 					
Ban Phoukang 	Ban Salueang 	Ban Phahu 	Ban Mongkhoh 					
Ban Hadchone 	Ban Saphim 	Ban Phalee 	Ban Tahkou 					
 	Longmounmexay 	 	Longmounchomkeo 					
ເມືອງ ວຽງພູຄາ ລະຫັດໄປສະນີ  03030 - 03032					
ລະຫັດໄປສະນີ ເຂດ 1: 03030					
Ban Viengsawang 	Ban Dongvieng 	Ban Mai 	Ban Thiew 					
Ban Nongkham 	Ban Nam-o	Ban Karpone 	Ban Lamone 					
Ban Phardaeng 	Ban Namaeng 	Ban Phoulan 	Ban Namsing 					
Ban Pahlang 	Ban Nammang 	Ban Dongmai 	Ban Namkieng 					
Ban Namsuea 	Ban Konethou 	Ban Thaluang 	Ban Phoulet 					
ລະຫັດໄປສະນີ ເຂດ 2: 03031					
Ban Thonghai	Thongnapaen 	Ban Namfa 	Ban Phonethong 					
Ban Namngern 	Ban Sakon 	Ban Lailord 	Ban Palangxaiy 					
Ban Namsing 	Ban Phoulantai 	Ban Namphae 	Ban Donemai 					
Ban Mueangaou 	Ban Namnoy 	Ban Nampamun 	Ban Pakkhan 					
ລະຫັດໄປສະນີ ເຂດ 3: 03032					
Ban Tarzoum 	Namkarpnuea 	Ban Huayhok 	Ban Namkarptai 					
Ban Thonglard 	Ban Nammaiy 	Ban Namtalaeng 	Ban Namvieng 					
Ban Phouyae 	Ban Namloung 	Ban Talong 	 					
ເມືອງ ລອງ ລະຫັດໄປສະນີ  03040 - 03048					
ລະຫັດໄປສະນີ ເຂດ 1: 03040					
Ban Chomchaeng 	Ban Huaythouyai 	Ban Huakhua 	 Ban Luangphakham 					
Ban Lukphamai 	Ban Doneyaeng	Ban Phortham 	 					
ລະຫັດໄປສະນີ ເຂດ 2: 03041					
Ban Donesawang 	Ban Yang-arn 	Ban Nongkham 	Ban Phonsawang 					
Ban Parkham 	Ban Taohom 	Phonsamphan 	Ban Chalernxay 					
ລະຫັດໄປສະນີ ເຂດ 3: 03042					
Ban Xiengkokmai 	Ban Tasoummai	Ban Sompanyao 	Ban Sala 					
Ban Sompanmai 	Ban Sompantai 	Ban Mueangkhan 	Ban Chayue 					
Ban Khalung 	Ban Huaykoum 	Ban HuayAor 	Ban Xiengkokkao 					
Ban Xienghoung 	Ban Kokmuang 	Ban Youngxaiy 	 					
ລະຫັດໄປສະນີ ເຂດ 4: 03043					
Ban Chavad 	Ban Donchai 	Soppankao	Chamkhamtan 					
Ban Sompanmai 	Ban Maekhing 	Phayaluangkhamping	Ban Namloiy 					
Ban Chakhamlee 	Ban Samsop 	Ban Phangua 	Ban Aiysaeng 					
Ban Nakham 			 					
ລະຫັດໄປສະນີ ເຂດ 5: 03044					
Ban Phakhae 	Ban Phorchon 	Chakhampon 	Ban Sivilai 					
Ban Kangkao 	Ban Namon 	Ban Daenkang 	Ban Huaymor 					
Chakhamtunkang 	Ban Huaylong 		 					
ລະຫັດໄປສະນີ ເຂດ 6: 03045					
Ban Namyo 	Ban Phontor 	Ban Chongka 	Parkuaymai 					
Ban Sahkao 	Ban Samai 	Ban Huaykha 	Ban Teendoy 					
Taiyhaimai 	Dunhaikao 	Ban Panghok 	 					
ລະຫັດໄປສະນີ ເຂດ 7: 03046					
Ban Thard 	Ban Silimoun 	Ban Huapoung 	Ban Sop-emai 					
Ban Pheoyaeh	Ban Sopmah 	Ban Phayaluang 	Ban Nammah 					
Luangphokham 	Ban Khokhin 	Ban Huana 	Ban Huanambuk 					
Ban Nambak 	Ban Saenthao 		 					
ລະຫັດໄປສະນີ ເຂດ 8: 03047					
Saenchompou 	Ban Champee 	Thongmortam 	Ban Phapeh 					
Ban Sopkha 	Ban Huaythoukao 	Phataehkao 	Ban Chamai 					
Ban Parzord 	Ban Huaythone 	Sarmmueangmai 	Ban Chetah 					
Ban Bor 			 					
ລະຫັດໄປສະນີ ເຂດ 9: 03048					
Ban Chommrok 	Ban Chakeonuea 	Ban Chakeotai 	Ban Charchanarm 					
Saenkhankhamkao	Saenkhankhammai 	Ban Pa-aor 	 					
Ban Chakhamtun 	Ban Aiyyang 	Ban Tong 	 					
								
								
								
								
								
								
								
								
								
								
								
								
								
								
								
ແຂວງ ອຸດົມໄຊ
ເລກລະຫັດໄປສະນີ 04000
ແຂວງອຸດົມໄຊ  04xxx							
ເມືອງໄຊລະຫັດໄປສະນີ  04000 - 04008          							
ລະຫັດໄປສະນີ ເຂດ 1: 04000							
Ban Vunghai 	Ban Viengsa 	Ban Nalao 	Ban Saenkham 							
Ban Phoukhiew 	Ban Nawarnnoy 	Ban Nanee 	Ban Homesouk 							
Ban Thin 	Ban Cheng 	Ban Nasaow 	Ban Luk 4 							
Ban Monetai 	Nongmaengda 	Huaykhoum 	 							
Ban Pasak 	Ban Donekeo 	Ban Thiew 	 							
Lorngkorduea 	Ban Donexay 	Ban Naley 	 							
ລະຫັດໄປສະນີ ເຂດ 2: 04001 							
Ban Konekaen 	Ban Nahuang 	Pangmaeng 	Ban Huaymork 							
Ban Vangmon 	Ban Huaykhoum 	Ban Vangyarn 	 							
ລະຫັດໄປສະນີ ເຂດ 3: 04002 							
Ban Bor 	Ban Kat 	Ban Longya 	Ban Huanambark 							
Ban Faen	Ban Pounghieng 	Ban Huayxang 	Ban Saenlard 							
Ban Mai 			 							
ລະຫັດໄປສະນີ ເຂດ 4: 04003 							
Ban Nangiw 	Ban Luk 20 	Ban Yaowyai 	Ban Luk 44 							
Mokkok Luk 16 	Ban Luk 28 	Ban Luk 37 	Ban Laova 							
Ban Naxaiythong 	Ban Luk 32 		 							
ລະຫັດໄປສະນີ ເຂດ 5: 04004 							
Ban Huayyum	Ban Homexay 	Ban Luk 10 	Ban Huayyang 							
Mounmueang 	 	 	 							
ລະຫັດໄປສະນີ ເຂດ 6: 04005 							
Ban Kornoy 	Ban Huaytam 	Ban Huaypor 	Ban Luk 22 							
Ban Huaytong 	Ban Huaykha 	 	 							
ລະຫັດໄປສະນີ ເຂດ 7: 04006 							
Ban Phonhome 	Ban Namvuen 	Ban Huayhia 	Ban Huaylieng							
Ban Vangmon 	Ban Huaylaaong 	Ban Nachang 	Ban Sanangpi 							
ລະຫັດໄປສະນີ ເຂດ 8: 04007 							
Huayaoun 	Ban Nangam 	Ban Mokchark 	Ban Lang 							
Thasalueang 	Ban Naaorm 									
ລະຫັດໄປສະນີ ເຂດ 9: 04008 							
Namhaeng 	Ban Tongpang 	Ban Nampra 	Ban Ta-aueng 							
Ban Saluang 	Ban Mokkha 	Ban Kiwchalou 	Ban Chomka 							
Ban Paen 	Ban Namchong 	Ban Chaaong 	Ban Tangkok 							
Ban kaer 	Ban Nampoung 	Ban Kaluah 	 							
ເມືອງ ຫລາ ລະຫັດໄສະນີ 04010 - 04016 							
ລະຫັດໄປສະນີ ເຂດ 1: 04010							
Ban Donesaath 	Ban Nongbua 	Ban Vangvan 	Ban Nakhoy 							
Ban Viengkham 	Ban Buamsom 	 	 							
ລະຫັດໄປສະນີ ເຂດ 2: 04011							
Tardmuan 	Ban Namlaeng 	Ban Mokhong 	Ban Tangngei 							
Huaythong 	Ban Mai 	Ban Phavee 	 							
ລະຫັດໄປສະນີ ເຂດ 3: 04012							
Ban Phonexay 	Ban Huayxou 	Ban Huayla 	Ban Tanongpor 							
Samukkheexay 	 	 	 							
ລະຫັດໄປສະນີ ເຂດ 4: 04013							
Ban Pakkor 	Ban Huayphae 	Ban Huakaeng 	Ban HuayAor 							
Ban Hadnin 	Ban Huaychaiy 	Phonsawang 	Ban Mokton 							
Ban HadAen 			 							
ລະຫັດໄປສະນີ ເຂດ 5: 04014							
Ban Phouthaen 	Ban Langleeng	Pangsabath	Ban Phousathi							
Ban Mai 	Phonesawath	 	 							
ລະຫັດໄປສະນີ ເຂດ 6: 04015							
Ban Chakpraeh 	Pangpor+Tongxer 	Ban Kokmaiyai 	Ban Huayzung 							
Ban Huaytonh			 							
ລະຫັດໄປສະນີ ເຂດ 7: 04016							
Ban Ano 	Ban Laowang 	Ban Moklahang 	Ban Pakpui 							
Ban Saenluang 	Ban Akhung	Ban Talohlom 	 							
ເມືອງ ນາໝໍ້ ລະຫັດໄປສະນີ 04020 - 04028							
ລະຫັດໄປສະນີເຂດ 1: 04020							
Ban Homexay 	Ban HuayAone 	Ban Namxey 	Ban Natong 							
ລະຫັດໄປສະນີເຂດ 2: 04021 							
Ban Namornuea 	Ban Namortai 	Ban Kiwlan 	Xaysamphan 							
ລະຫັດໄປສະນີເຂດ 3: 04022 							
Ban Nahom 	Ban Huayxang 	Ban Pangdou 	Ban Huanamkham+
Nammout 							
Ban Namphaeng 	Ban Pangthong 	Ban Nakharm 	 							
ລະຫັດໄປສະນີເຂດ 4: 04023 							
Ban Pangsa 	Ban Huayhok+Saenxay 	Ban Phoutoum 	Ban Phoulee 							
Ban Paknamtong 	Ban Chomsaen 		 							
ລະຫັດໄປສະນີເຂດ 5: 04024 							
Ban Nathua 	Ban Nathong 	Ban Kiwchaep 	Ban Bortakai 							
Ban Namvuen 	Namvuennuea 	Ban Koulong 	Ban Narkchouk 							
ລະຫັດໄປສະນີເຂດ 6: 04025 							
Ban Laow 	Ban Phaeng 	Phouauead 	Ban Huaypord 	 						
Ban Phouthong 	Ban Phoukhuea 	Ban Huayhu 	Ban Huaysoy 							
ລະຫັດໄປສະນີເຂດ 7: 04026 							
Ban Huayhaer 	Ban Huayha 	Ban Namtong 	Ban Phouaom 							
Ban Vung-arng 			 							
ລະຫັດໄປສະນີເຂດ 8: 04027							
Ban Sangaer 	Ban Tao 	Ban Mokkha 	Ban Sakua							
ລະຫັດໄປສະນີເຂດ 9: 04028 							
Khuangkham 	Ban Mainatao 	Ban Namkor 	Ban Mutuem 							
Ban Nasawang 	Ban Nammong 	 	 	 						
ເມືອງ ງາ ລະຫັດໄປສະນີ 04030 - 04038 							
ລະຫັດໄປສະນີເຂດ 1: 04030 							
Ban Done-aen 	Ban Mueangnga 	Ban Huaykhan 	Ban Thin							
Ban Donengiw 	 	 	 							
ລະຫັດໄປສະນີເຂດ 2: 04031 							
Ban Huayxei 	Ban Huaylieng 	Ban Nongtao 	 							
ລະຫັດໄປສະນີເຂດ 3: 04032 							
Ban Mai 	Ban Huaypong 	Ban Huaylerm 	Ban Nakhok 							
Ban Phonkham 	 	 	 							
ລະຫັດໄປສະນີເຂດ 4: 04033 							
Tongtunoy+Huaylun 	Ban Saenxay+
Huaytueang 	Hongthuyai+
Noy 	Huaylai+Phousee 							
ລະຫັດໄປສະນີເຂດ 5: 04034 							
Ban Huaylaper 	Ban Kiwlakham	Ban Parkhuay-nguan	Ban Phouhuadyai							
Ban Huaylerm	Ban Pakhuaylao	mokchalaeng	Ban Saenchord+
Huayhok							
Ban Huaysalark			 							
ລະຫັດໄປສະນີເຂດ 6: 04035 							
Huaykhayaiyyai	Ban Mokkavarn	Ban Huaylorm	Ban Khokphou							
Huaykhayaiynoy	Ban Huayporm	Huayphang	Ban Yoiyhai							
Ban Thakuang			 							
ລະຫັດໄປສະນີເຂດ 7: 04036 							
Ban Huaychan+
Huaymuang	Ban Huayo	Huayyueng	Ban Phouchi							
Phousoungnoy	Ban Huayphung	Ban Nanueang	 							
ລະຫັດໄປສະນີເຂດ 8: 04037 							
Ban Phonsawang	Ban LadAen	Ladkhamoun	Ban Ladhan							
Ban Hadkharm	Ban Huayhing	Ban Huayhin	Ban Hadter							
Ban Ladkuem	 	 	 							
ລະຫັດໄປສະນີເຂດ 9: 04038 							
Huayyueang	Huayzan+Kiwving	Ban Huayyen+
Thaen	Ban Huaychi							
Nazan+Huaymo	Huaykha+Bor	 Ban khoun	 							
ເມືອງແບງ ລະຫັດໄປສະນີ 04040 - 04046 							
ລະຫັດໄປສະນີເຂດ 1: 04040 							
Baengluang	Ban Phokeo	Ban Nangiw	Ban Phoukham							
Baengkham	Ban Pangduea	Ban Nalai	Ban Huayhouk							
Ban Huayla	Ban Konekham	Ban Bor	Ban Namdor							
Ban Thakard	Ban Nabone	Ban Xienglae	Ban Phoxay							
Ban Nahuay	 	 	 							
ລະຫັດໄປສະນີເຂດ 2: 04041 							
Ban Huaylor	Ban Mang	Ban Thamuen	Ban Kiwsungvan							
Ban Nangua	Ban Pangyom	Ban Namaed	Ban Phiahuanam							
Ban Huayhok	Ban Pangthong	Napanuea+Tai	 							
Ban Phouyout	Ban Namtui	Phonsaath	 							
ລະຫັດໄປສະນີເຂດ 3: 04042 							
Homxaykham	Ban Pangsom	Ban Nampor	Ban Vungvah							
Ban Phonsee	Ban Sarmkang	Ban Namone	 							
ລະຫັດໄປສະນີເຂດ 4: 04043 							
Ban Namkhong	Ban Tongthoun	Ban Chanmai	Ban Mokvieng							
Ban Khone			 							
ລະຫັດໄປສະນີເຂດ 5: 04044 							
Ban Phakeo	Nahom+Luk	Ban Saensee	Ban Hamua							
Ban Phouloung			 							
ລະຫັດໄປສະນີເຂດ 6: 04045 
						
Ban Phouho	Ban Laiyai	Ban Lainoy	 							
ລະຫັດໄປສະນີເຂດ 7: 04046 
						
Ban Porm	Ban Pong	Ban Tangchong	Ban Kanvang							
Ban Tangthu	Ban Kam		 							
ເມືອງ ຮຸນ ລະຫັດໄປສະນີ 04050 - 04059 
						
ລະຫັດໄປສະນີເຂດ 1: 04050
						
Phonesawath	Ban Donekham	Ban Somxay	Ban Nangern							
Phonsavanth	Ban Donekeo	Ban Huaypha	Ban Vungtung							
Ban Nafang	Ban Vunglam	Ban Faen	Ban Langching							
Nongbuadaeng	Ban Nahome	Ban Na	 							
Ban Nakhong	Ban NamAoun	Ban Nakham	 Ban Nakham							
ລະຫັດໄປສະນີເຂດ 2: 04051 							
Ban Chantai	Ban Namkhor	Seeboun-hueang	Ban Namnoy							
Ban Konekham	Ban Navang	Ban Phiengya	Ban Aoudom							
Mokpaiy+Moksuan	Ban Namyone	Huanammaow	Ban Namnieng							
Ban Phangam	Ban Buamlao	Ban Kiewpha	 							
Ban Nathong	Ban Long-in	Phonsawang	 							
ລະຫັດໄປສະນີ ເຂດ 3: 04052							
Ban Namphoun	Ban Chanvang	Mokhung	Phoulad							
Ban Phousone	Ban Konethei	Phoulao	 							
ລະຫັດໄປສະນີ ເຂດ 4: 04053							
Phouviengxay	Ban Namkuang	Ban Phouyuak	Ban Konetong							
Mokkachork	Ban Mokkha		 							
ລະຫັດໄປສະນີ ເຂດ 5: 04054							
Ban Huayhok	Ban Phouthong	Chongnung	Ban Phayam							
Ban Chaeng			 							
ລະຫັດໄປສະນີ ເຂດ 6: 04055							
Ban Phoutoum	Ban Lorngkhoun	Ban Namphak	Phoukhoy (Tadtalae)							
Kongnueang	Ban Tanglon	Ban Phoulord	 							
Ban Tangya	Ban Phouxae	Ban Dou	 							
ລະຫັດໄປສະນີ ເຂດ 7: 04056							
Ban Phonxay	Ban Ngiw	Ban Donna	Ban Katangya							
Ban Phouphon	 	 	 							
ລະຫັດໄປສະນີ ເຂດ 8: 04057							
Ban Naxiengdy	Ban Phienghor	Ban Namnong	Ban Mokchark							
Ban Kiwyarp	Ban Chomlaeng	Ban Keo	 							
Ban Namai	Ban Namyueng	Ban Mae	 							
ລະຫັດໄປສະນີ ເຂດ 9: 04058							
Ban Namphuan	Ban Phonkham	Ban Mokluk	 							
ລະຫັດໄປສະນີ ເຂດ 10: 04059							
Ban Namtam	Ban Mokphord	Ban Taluep	 							
ເມືອງ ປາກແບງ ລະຫັດໄປສະນີ 04060 - 04067  							
ລະຫັດໄປສະນີ ເຂດ 1: 04060							
Ban Parkbaeng	Ban Donesaath	Ban Huaykah	Ban Parkngei							
Ban Kaengxang	Huaysaengkham	 	 							
ລະຫັດໄປສະນີ ເຂດ 2: 04061							
Ban Donchaeng	Ban Huaython	Ban Huaylao	Ban Kiwkhoui							
ລະຫັດໄປສະນີ ເຂດ 3: 04062							
Ban Xaysana	Ban Huanampa	Phouluang	Ban Mokphang							
ລະຫັດໄປສະນີ ເຂດ 4: 04063							
Chomlaengyai	Ban Mokkhaeh	Ban Phouxang	Ban Kongvang							
Chomlaengnoy	Ban Phousoung	Ban Konelang	 							
ລະຫັດໄປສະນີ ເຂດ 5: 04064							
Mokkhoyai	Ban Moksatong	Mokchongyai	Ban Langching							
Ban Moktou	Ban Mokkan	Mokkhokang	 							
ລະຫັດໄປສະນີ ເຂດ 6: 04065							
Ban Mokwaen	Ban Taengsa	Phouluang	Mokvath							
Ban Phouhoung	Ban Phalorm	Chomxangnam
yen	Longyong							
Ban Kaenglae	Ban Tong	Katangtone	 							
ລະຫັດໄປສະນີ ເຂດ 7: 04066							
Ban Tangone	Ban Khokkah	Chomsaen	Mokprailoum							
Ban Namyen	Ban Homexay	Huaymong	Mokpraikang							
Ban Kang	 	 	 							
ລະຫັດໄປສະນີ ເຂດ 8: 04067							
Ban Soukxay	Ban Ngone	Ban Ping	Ban Kar							
Ban Kham	Ban Longtong	Ban Phieng	 							
										



ແຂວງ ບໍ່ແກ້ວ
ເລກລະຫັດໄປສະນີ 05000
ແຂວງບໍ່ແກ້ວ  05xxx	
ເມືອງ ຫ້ວຍຊາຍ ລະຫັດໄປສະນີ  05000 - 05005         	
ລະຫັດໄປສະນີ ເຂດ 1: 05000	
Ban Namyonekao	Pakngaow	Ban Huaytarp	Ban Yaihuayxaiytai	 
Ban Namponeyai	Ban Donkhoun	Ban Huaymone	Ban Nongxaiy	 
Yaihuayxaynuea	Ban Khonekeo	Ban Teenthad	 	 
ລະຫັດໄປສະນີ ເຂດ 2: 05001	
Ban Pa-aoiy	Mokkachork	Namhortai	Ban Viengmai	
Ban Danthin	Seeboun-hueang	Phibounthong	Ban Done	
Ban Namkham	Parkhaowtai	Ban Maiphoukha	 	
ລະຫັດໄປສະນີ ເຂດ 3: 05002	
Chomchouk	Ban Namtoy	Pakhaonuea	Ban Donephaow	
Thongsaengchan	Ban Nampou	Namchang	Ban Phonkham	
Ban Xaychalern	Ban Nammar	Ban Phokham	 	
ລະຫັດໄປສະນີ ເຂດ 4: 05003	
Ban Phonthong	Ban Namteen	Ban Phouwantai	Ban Phonxay	
Ban Borlek	Phouwannuea	Ban Huaythui	Ban Huaychord	
ລະຫັດໄປສະນີ ເຂດ 5: 05004	
Ban Phonsawang	Ban Aoudom	Ban Faiy	Ban Donesavanth	
Ban Namphaed	Huayxaiynoy		 	
ລະຫັດໄປສະນີ ເຂດ 6: 05005	
Ban Nongkham	Ban Xord	Ban  Nampong	Ban Namchuam	
Ban Phimonsin	Ban Seephoxay		 	
ເມືອງ ຕົ້ນເຜີ້ງ ລະຫັດໄປສະນີ 05010 - 05013	
ລະຫັດໄປສະນີ ເຂດ 1: 05010	
Ban Luangseexay	Ban Huaykhai	Ban Tonpherng	Ban Viengsavanth	
Ban Huaytang	Ban Yangkham		 	
ລະຫັດໄປສະນີ ເຂດ 2: 05011	
Muangkham	Ban Phiengngam	Donesavanth	Setthakidsamliemkham	
Seebounhueang	Ban Donemoun	Donethad	 	
Sarmliemkham	Ban Phonhome		 	
ລະຫັດໄປສະນີ ເຂດ 3: 05012	
Yaitonpherng	Ban Seethad	Namkaeng-mai	Ban Seedoneyaeng	
Ban Ngaen	Yaiseemueang
Ban ngam	Ban Seedonexay	 	
ລະຫັດໄປສະນີ ເຂດ 4: 05013	
Ban Korsang	Ban Yangtai	Phonesavanh	Ban Buachalern	
Namkerngkao			 	
ເມືອງ ເມິງ ລະຫັດໄປສະນີ 05020 - 05022	
ລະຫັດໄປສະນີ ເຂດ 1: 05020	
Ban Phonsawang	Ban Xaychalern	Ban Huaythad	Ban Xayphatthana	
Ban Nammerng	Ban Ladkhoun-
mueang			
ລະຫັດໄປສະນີ ເຂດ 2: 05021	
Ban Huanamkha	Phakhaow	Ban Phadam	Ban Namkhaly	
ລະຫັດໄປສະນີ ເຂດ 3: 05022	
Ban Thaphabath	Chomchaeng	Ban Xaysawang	Ban Lorngphabath	
ເມືອງ ປາກທາ ລະຫັດໄປສະນີ 05030 - 05032	
ລະຫັດໄປສະນີ ເຂດ 1: 05030	
Ban Yaipaktha	Ban Phonthong	Ban Hadsah	Ban Huaysuah	
Ban Huaythong			 	
ລະຫັດໄປສະນີ ເຂດ 2: 05031	
Haddonekeo	Kaengphark	phousathaen		
ລະຫັດໄປສະນີ ເຂດ 3: 05032	
Ban Konetuen	Huaykhode	Ban Dong	Ban Chiengtong	
ເມືອງ ຜາອຸດົມ ລະຫັດໄປສະນີ 05040 - 05043	
ລະຫັດໄປສະນີ ເຂດ 1: 05040	
Ban Hadly	Ban PakHad	Ban Nahome	Ban Donekeo	
Ban Pangthong			 	
ລະຫັດໄປສະນີ ເຂດ 2: 05041	
Soukchalern	Ban Seeboun-hueang	Ban Kaenkham	 	
ລະຫັດໄປສະນີ ເຂດ 3: 05042	
Ban Phousoung	Phiengkham	Ban Huaysung	Ban Mai	
Ban Kang	Phouvieng		 	
ລະຫັດໄປສະນີ ເຂດ 4: 05043	
Viengkhamyai	Ban Yaithinkeo	Ban Xaysawang	Ban PhaAoudom	
Ban Somsawang	Ban XayAoudom	Viengkham-noy	 	







ແຂວງ ຫລວງພະບາງ
ເລກລະຫັດໄປສະນີ 06000
ແຂວງ ຫລວງພະບາງ 06XXX						
ເມືອງຫລວງພະບາງ 06000-06007						
ລະຫັດໄປສະນີ ເຂດ 1: 06000						
Ban Huaxieng	Ban Viengxay	Ban Pongkham	Ban Phabath						
Thongchalern	Ban Viengkeo	Ban Nasamphan	Ban Saiylom						
Ban Vatthad	Ban Mano	Phonphaeng	Ban Phosy						
Ban Thadluang	Naviengkham	Ban Naluang	 						
ລະຫັດໄປສະນີ ເຂດ 2:  06001						
Ban Parkharm	Phonhueang	Kharmyong	Ban Muenna						
Choumkhong	Ban Vatsaen	Ban Aharm	Ban Viengmai						
Ban Xiengmuan	Ban Kheely	Ban Aphai	Ban Thadbosod						
Ban Vatnong	Xiengthong	Ban Veezoun	Ban Naxangvei						
ລະຫັດໄປສະນີ ເຂດ 3:  06002 						
Mueangnga	Xangkhong	Khomekhuang	Ban Phasouk						
Phanluang	Nongxaiy	Ban Donekao	Ban Phanom						
Phonsaath	Ban Khokva	Ban Donemai	Ban Donekeo						
Xienglek	Phakhome	Ban Hadhien	 						
ລະຫັດໄປສະນີ ເຂດ 4:  06003 						
Nongkham	Ban Xiengkeo	Ban Donekang	Ban Luk 8						
Ban Khoy	Ban Pongwarn	Ban Luk 10	Ban Phonxay						
Naxang	Ban Nadueay	Ban Chomngua	 						
Phoumork	Ban Mar	Huayauead	 						
Sangkhaloke	Khuathee 1	Ban Huayphaiy	 						
ລະຫັດໄປສະນີ ເຂດ 5: 06004 						
Ban Phonexay	Ban Saensouk	Viengsavath	Ban Phonngam						
Ban Pha-o	Pakxueang	ຮ/ຮ ກະສິກຳພາກເໜືອ	Ban Pakpa						
ລະຫັດໄປສະນີເຂດ 6:  06005						
Ban Korkwan	Ban ThaAoui	Ban Phadaeng	Ban Longlan						
Ban Borhaer	Ban Huaylerk	Ban Phavieng	 						
ລະຫັດໄປສະນີ ເຂດ 7:  06006 						
Nounsavath	Ban Xienglorm	Ban Natan	 						
Ban Phiknoy	Ban Kokngiw	Nadorkkhoun	 						
Ban Phikyai	Phonsawang	Phonsavath	 						
ລະຫັດໄປສະນີ ເຂດ 8:  06007 						
Ban Xiengmuak	Ban Huaythong	Ban Longlao 1	 						
Ban Xard	Ban Nongton	Ban Longlao 2	 						
Ban Parnor	Ban Teenpha	Ban Naxay	 						
ເມືອງ ຊຽງເງິນ 06010 - 06015						
ລະຫັດໄປສະນີ ເຂດ 1:  06010 						
Ban Pakkhun	Ban Nakha	Ban Longsan	 						
Ban Xiengngern	Ban Pakthor	Ban Moud	 						
Ban Donemo	Ban Pakvaed	Samukkheexay	 						
ລະຫັດໄປສະນີ ເຂດ 2:  06011 						
Ban Suanluang	Ban LongAor	Ban Huaywaii	 						
Ban BuamAor	Aen	Phonxieng	 						
Huayyen	Suandala	Huaythao	 						
ລະຫັດໄປສະນີ ເຂດ 3:  06012 						
Huaykhode	Nongkhuay	Phonxay	Thinkeo						
Huaykhang	Huayphaeng	Phonsawang	Saenkoun						
ລະຫັດໄປສະນີ ເຂດ 4:  06013 						
Phouxang	Pakfaen		 						
ລະຫັດໄປສະນີ ເຂດ 5:  06014 						
Ber 10	Ber 11	Seelalek	 						
ລະຫັດໄປສະນີ ເຂດ 6:  06015 						
Kiwyar	Huaykouk	kiwchaluang	Kiwmaknao 1						
Phonsaath	Huayhia	Phoukhua	Kiwmaknao 2						
ເມືອງ ນານ 06020 - 06026						
ລະຫັດໄປສະນີ ເຂດ 1: 06020						
Nafaiy	Seemoung khoun Village	Donetoum	Thongphiengvilay Village						
Nalao	Seeboun hueang Village	Parpherm	Pakkhone Village						
Parphai	Thad Village	Nakhern	Huayla Village						
Phonheen	Phon Village	Sivilay	Keomany Village						
ລະຫັດໄປສະນີ ເຂດ 2 : 06021						
Namueangyai Village	Huaylad	Phaneep	Phayuak						
Namueangkang Village	Pongdong		 						
ລະຫັດໄປສະນີ ເຂດ 3: 06022						
Thalee	Touhor	HuayAoun	Phakuang						
ລະຫັດໄປສະນີ ເຂດ 4: 06023						
Huayhom	Phatonglom	Namphuk	Huaymaeh						
Thongkhung	Huaysala	Dan	 						
ລະຫັດໄປສະນີ ເຂດ 5: 06024						
Khoktom	Huaykhong	Khorlae	Hadxaiykham						
Huayhia 	Nanuan	Naleen	 						
ລະຫັດໄປສະນີ ເຂດ 6: 06025						
Thongchalern	Phonxay	Huayphuknao	Phonsy						
ລະຫັດໄປສະນີ ເຂດ 7: 06026						
Nernsawang	Kang	Pakphee	Parkbor						
ເມືອງ ປາກອູ 06030 - 06037						
ລະຫັດໄປສະນີ ເຂດ 1: 06030						
Somsanouk 	Hadkharm 	Huaymard 	Phadaeng 	 					
Hadya 	Vanglae 	 	 	 					
ລະຫັດໄປສະນີ ເຂດ 2: 06031						
ParkAou 	Khoke 	Khokekharm 	Huaykharm 						
Hadmard 	Xanghai 		 						
ລະຫັດໄປສະນີ ເຂດ 3: 06032						
Hadkhor 	Phathueng 	Huayloh 	Thahae 						
Huaykhor 	Khonekham 		 						
ລະຫັດໄປສະນີ ເຂດ 4: 06033						
Nasawang 	Huaykuen 	Huaykham 	Mokchong						
Haykork 	Nanoy 		 						
ລະຫັດໄປສະນີ ເຂດ 5: 06034						
Parkchaek 	Hadzua 	Huaylueang 	Faiy 						
Ladkork 			 						
ລະຫັດໄປສະນີ ເຂດ 6: 06035						
Hadpang 	Huaypaen 	Huaymark 	Khokhan 						
Hadkhae 	Nonsavath 	Huaylae 	Huaykang 						
Kiet 			 						
ລະຫັດໄປສະນີ ເຂດ 7: 06036						
Siew 	Phonsawang 	Laesivilay 	Hakkhung 						
Thinchalern 	Phonhome 	Khialuang 	 						
ລະຫັດໄປສະນີ ເຂດ 8: 06037						
Phapon 	Huayyen	Buakkhuay 	Yarnang 						
HuayAode 	Huaylern 		 						
ເມືອງ ນໍ້າບາກ 06040 - 06046						
ລະຫັດໄປສະນີ ເຂດ 1: 06040						
Phonsaath 	Phonxay 	Namkharm 	Namla 						
Far 	Thalee 	Khong 	Bom 						
Phonhome 									
ລະຫັດໄປສະນີ ເຂດ 2: 06041						
Nakhone 	Huayyang 	Lee 	Donekham 						
Viengkham 	Monluk 		 						
ລະຫັດໄປສະນີ ເຂດ 3: 06042						
Nayangnuea 	Huaykong 	Huayhar 	Huayyen 						
Nayangtai 	Poungchong 	Huayheed 	Vienghinsoung 						
Namai 	 	 	 						
ລະຫັດໄປສະນີ ເຂດ 4: 06043						
Khantherng 	Phathong 	Kheengkang 	Duantai 						
Lankang 	Huaysuea 	Pakkhun 	Khunloum 						
ລະຫັດໄປສະນີ ເຂດ 5: 06044						
Pakmorng 	Vangkham 	Nammorng 	Dorklao						
Nakork 	Vanghin 	Kahchet 	Krang 						
ລະຫັດໄປສະນີ ເຂດ 6: 06045						
Nongkeo 	Khoknang 	Laowlao 	Thongtherng 						
Huayyim 	Mueangtaeng 	 	 						
ລະຫັດໄປສະນີ ເຂດ 7: 06046						
Xongcha	Luk 50	Lorngchoke	Yahlo						
Markphouk	Phouker		 						
ເມືອງ ງອຍ 06050 - 06059; 06150						
ລະຫັດໄປສະນີ ເຂດ 1: 06050						
Nongkiew	Sophoun 	NongAien 	Huaylek 						
Parkbark 			 						
ລະຫັດໄປສະນີ ເຂດ 2: 06051						
Sopkhing 	Chaengkang 	Moklaep 	Vangngou 						
Pakluang 	Huaylortherng 	Phonsana 	 						
Hadkharm 	Huaylorsoung 	Hadsa 	 						
ລະຫັດໄປສະນີ ເຂດ 3: 06052						
Sopkhan 	Hadchun 	Sopkong 	Huayhoy 						
Phayorng 			 						
ລະຫັດໄປສະນີ ເຂດ 4: 06053						
Phoutidpherng 	Lorngkham 	Phouvieng 	Katangxieng 						
Huayxeo 	Huaypoung 	Huaykherng 	 						
Phouluang	Hinpaen 	Laowlao 	 						
ລະຫັດໄປສະນີ ເຂດ 5: 06054						
Paknga 	Hadkheep 	Hadphang 	Huayphang 						
Donengern 			 						
ລະຫັດໄປສະນີ ເຂດ 6: 06055						
Mueangngoykao	Ban Hadsaphei	Ban Nakang	Ban Huaysaen						
Ban Sopchaem	Ban Donelorm	Ban Huaybor	Ban kiwkhan						
ລະຫັດໄປສະນີ ເຂດ 7: 06056						
Ban Phonxay	Ban Xang	Ban Huayna	Ban Phon						
Ban Don	Ban Phonsavan	Ban Phonkham	Ban Huaythong						
Ban Huayngon	Ban Chomying	Ban Kiwkarn	 						
ລະຫັດໄປສະນີ ເຂດ 8: 06057						
Ban Khonekerng	Ban Nongkham	Thaenkhaen	Ban Huaykhaen						
Ban Pakcheem	Ban Huaychim		 						
ລະຫັດໄປສະນີ ເຂດ 9: 06058						
Ban lard-aen 	Ban Huayhang	Ban Hardhuan	Ban Monlek						
Ban Huaykoung	Ban Dorkkhoun	Ban Toupnai	 						
ລະຫັດໄປສະນີ ເຂດ 10: 06059						
Mueangxuen	Ban Huaylae	Ban Mai	Ban Phusoung						
Ban Nalae	Ban Lungpha		 						
ລະຫັດໄປສະນີ ເຂດ 11: 06150						
Ban Sopvan	Ban Hardzaow	Ban Huaylarn	Ban Mokdou						
ເມືອງ ປາກແຊງ 06060 - 06063						
ລະຫັດໄປສະນີ ເຂດ 1: 06060						
Parkzaeng	Hardpha-aod	Ban Napho	Ban Hardhuay						
Ban Hardngam	Ban Hardzam	Ban Huaypho	Ban Hardsang						
Buamphasaeng	Ban Donekhoun	Ban Hardheed	Ban Hardsangone						
Ban Huaython	Ban Nongfadaed	Ban Huasakhing	Ban Pakkeng						
Ban Vungngern	Ban Sopchaek	Ban Phounorwan	Ban Huakaeng						
ລະຫັດໄປສະນີ ເຂດ 2: 06061						
Ban Vungphom	Ban Hardtuen	Ban Hardkeo	Ban Namai						
Ban Sopphueak	Ban Hardkhaen	Ban Sopchoh	Ban Phabuk						
Ban Hardyen 	Muangkham	Ban Phonthong	 						
ລະຫັດໄປສະນີ ເຂດ 3: 06062						
Ban Vung-aor	Longaueang	Ban Huayyor	Ban Hardchang						
Ban Huaysa-aou	Ban Sopvat	Ban Ngiw	Ban Viengthong						
Ban Pho	Ban Nong	Ban Sanaen	Ban Hardwan						
Ban Hardphoun	Ban Thathien	Ban Lungkone	Ban kiwauead						
BanTardsaeng	BanHuaymod	Ban Sahkuan 	Ban Buamkhoun						
Ban Huayyen	BanHuaychon	Ban Buamkork	Ban Huaythong						
ລະຫັດໄປສະນີ ເຂດ 4: 06063						
Ban Nardkham	Ban Huayvat		 						
ເມືອງ ໂພນໄຊ 06070 - 06079						
ລະຫັດໄປສະນີ ເຂດ 1: 06070						
Ban Parknga	 	 	 						
ລະຫັດໄປສະນີ ເຂດ 2: 06071						
Ban Tharkharm	Huayloungtherng	Ban Sunkang	Ban phatoup-tai						
Ban Huayvaha	Ban Huaynga	Ban Huaypien	Ban phatoup-nuea						
Ban Poungpao			 						
ລະຫັດໄປສະນີ ເຂດ 3: 06072						
Ban Nambor	Ban Thapho	Ban Huaysala	Ban Nongkham						
Ban Huaymun	Ban Huaynoh	Ban Huayloy	 						
ລະຫັດໄປສະນີ ເຂດ 4: 06073						
Lungkingpha-taem	Ban Longyuak	Ban Longngaed	Ban Longyomyai						
ລະຫັດໄປສະນີ ເຂດ 5: 06074						
Katangsalueang	Ban Parksim	Sunphouluang	Ban Kangsun						
Ban Pounglat	Ban hintung	Ban Huayhaow	Ban Kokngiw						
ລະຫັດໄປສະນີ ເຂດ 6: 06075						
Ban Chomchieng	Ban Hueadoiy	Ban Huaypha	Ban Naphieng						
Huayloungsoung	 	 	 						
ລະຫັດໄປສະນີ ເຂດ 7: 06076						
Ban Sopchia	Ban Tardthong	Huayleeyom	Ban Huaydong						
Ban Donexay	Huamueang	Ban Huaychia	Ban Phuk-hok						
ລະຫັດໄປສະນີ ເຂດ 8: 06077						
Ban Huaykhing	Ban Huayha	Ban Huaytho	Ban Sakuan						
Ban Phukbong	Ban Lornglard		 						
ລະຫັດໄປສະນີ ເຂດ 9: 06078						
Ban Phonthong	Ban Buakkham	Viengchalern	Ban Nangoiy						
Ban Nangiw	Ban Vungkhone	Ban Kiwlai	 						
ລະຫັດໄປສະນີ ເຂດ 10: 06079						
Ban Donekham 	Ban Sophoud	Ban Parkvung	Ban Hardchong						
ເມືອງ ຂາຍ 06080 - 06081						
ລະຫັດໄປສະນີ ເຂດ 1: 06080						
Ban Nazaow	Ban Nonsa-ard	Ban Mueangkhaiy	Ban Huaysiew						
Ban Napho	Ban Nongheo	Ban Aou	Ban Khokman						
Ban Na-auan	Ban Thinxom	Ban Thapaen	Ban Yang						
Ban Sing	Ban Thinkeo	Ban Parkzee	 						
ລະຫັດໄປສະນີ ເຂດ 2: 06081						
Ban Xaenkhalok	Ban Huaychia	Ban Nongzaiy	Ban Khokya						
Ban Honglorng	Ban Huayharn	Ban Parkphoc	 						
ເມືອງ ວຽງຄຳ 06090 - 06098						
ລະຫັດໄປສະນີ ເຂດ 1: 06090						
Ban Saer	Ban Vungherng	Ban Hardkor	Ban Huaysoy						
Ban Vungbai	Ban Hardyaow	Ban Thavarn	Ban Chukkang						
ລະຫັດໄປສະນີ ເຂດ 2: 06091						
Ban Kiwlai-tai	Ban Huaykuang	Ban Donekhoun	Ban Mai						
Ban Kiwlai-nuea	Ban Buamwarn	Ban Nammee	Ban Yorngyar						
Ban Chongtai	Phuphukpheo		 						
ລະຫັດໄປສະນີ ເຂດ 3: 06092						
Ban Sarmton	Ban Phonkham	Ban Phonngarm	Ban Huayzuang						
Ban Huaychan			 						
ລະຫັດໄປສະນີ ເຂດ 4: 06093						
Ban Sarmsoum	Ban Huaythong	Ban Nanoy	Ban Phoukeo						
Ban Huayjoc	Ban Huayku	Ban Huaymone	Ban Phoukang						
Ban Aombring	     Ban Phukhorng	Ban Namlao	Ban Viengxay						
ລະຫັດໄປສະນີ ເຂດ 5: 06094						
Ban Mueangnoy	Ban Vunhkham	Ban Parklao	Ban Huaykon						
Ban Donekeo	Ban Buammee	 	 						
ລະຫັດໄປສະນີ ເຂດ 6: 06095						
Ban Sophueang	Ban Viengthong	Ban Navaen	Ban Nongkham						
Ban Toumming	Ban Namzoy	Ban Thardhien	Ban Huayphieng						
Ban Parphai			 						
ລະຫັດໄປສະນີ ເຂດ 7: 06096						
Ban Phousanarm	Ban Phousalee	Ban Sar	Ban Moktanet						
Ban Phoutong	Ban Mokvat	Ban Phoukham	Ban Mokserk						
ລະຫັດໄປສະນີ ເຂດ 8: 06097						
Ban Mokkha	Ban Poungkao	Ban Huaykaih	Ban Phonhome						
Ban Pardxang	Ban Mokchalee	Ban Phonkeo	 						
ລະຫັດໄປສະນີ ເຂດ 9: 06098						
Ban Vungbong	Ban Nakang	Ban Hardlao	Ban Hardhoung						
Ban Sopxang			 						
ເມືອງ ພູຄູນ 06100 - 06105						
ລະຫັດໄປສະນີ ເຂດ 1: 06100						
Ban Sarmyaek	Ban Viengkham	Ban Bungkalo	Ban Lukhar						
Ban Phoukhounnoy	Ban Saensy		 						
ລະຫັດໄປສະນີ ເຂດ 1: 06101						
Ban Phouvungchung	Ban Phousoung	Ban Phouyang	Ban Suanmark						
Ban Lorngmieng			 						
ລະຫັດໄປສະນີ ເຂດ 1: 06102						
Ban Phakeng-noy	Ban Xaiythong	Ban Phoulei	Ban Huaysataep						
Ban Phakeng-yai	Ban Tungaoui	Ban Phonxay	Ban Namsuan						
Ban Chongaueay	 	 	 						
ລະຫັດໄປສະນີ ເຂດ 2: 06103						
Ban Phakeo	Ban Lorngpode	Ban	Ban Nammadao						
Ban Phawaii			 						
ລະຫັດໄປສະນີ ເຂດ 3: 06104						
Ban Phalungmu	Ban Thongsata	Ban Hintung	 						
ລະຫັດໄປສະນີ ເຂດ 4: 06105						
Ban Phouvieng-yai	Ban Phonkham	Ban Somboun	Ban Namlaow						
Ban Phouvieng-noy	Ban Nanarn	Ban Namting	Ban Donengern						
Ban Viengsamai	Ban Nakuen	Ban Buamphor	 						
ເມືອງ ຈອມເພັດ 06110 - 06118						
ລະຫັດໄປສະນີ ເຂດ 1: 06110						
Ban Xiengman	Ban Nakham	Ban Charn-tai	Thapho-Lardkhok						
Ban Thana	Ban Charn-nuea	 	 						
ລະຫັດໄປສະນີ ເຂດ 2: 06111						
Ban Na	Ban Xam-aor	Ban Huaypong	Ban Huaytarn						
Ban Phouluangtai	Ban Muangkham	Ban Sanok-Moungkhoun	Ban Bansome						
Ban Huayzaeng	Ban Nazaychalern		 						
ລະຫັດໄປສະນີ ເຂດ 3: 06112						
Ban Buamlao	Ban Huaymard	Ban Kueap	Ban Huaymieng						
Ban Huay-orn	Ban Buamxieng	Ban Choke	Ban Huaythum						
ລະຫັດໄປສະນີ ເຂດ 4: 06113						
Ban Saluean	Ban Nongphou-Chong	Ban Donexay	Ban Huaythark						
Ban Parklueng	Parkhuaykhor	Ban Na-arng	Phoumieng-kiwparn						
ລະຫັດໄປສະນີ ເຂດ 5: 06114						
Ban Thinhong	Ban Muangkeo	Ban Huayyor	Ban Huaykhaer						
Ban Huaykor	Ban Nasung	Ban Phonhome	 						
ລະຫັດໄປສະນີ ເຂດ 6: 06115						
Ban Nakuea	Ban Nangiw	Ban Sumphanxay	Ban Kiwthaeng						
Ban Nakhaeng	Ban Nahai	Ban Huayxaykhaow	Ban Huaysaer						
Ban Huaykharn	Ban Tardlaer		 						
ລະຫັດໄປສະນີ ເຂດ 7: 06116						
Ban Parkluem	Ban Zorngtai	Ban Huaykatoy	Phouluang-Kingaoung						
Ban Zorngnuea	Ban Huaytaow		 						
ລະຫັດໄປສະນີ ເຂດ 8: 06117						
Ban Kaengkhaen	Ban Khokluang	Ban Lae	Ban Nakang						
Kokngiw-Lorngxieng	Ban Tone	Ban Parkkon	Ban Kaenghang						
ລະຫັດໄປສະນີ ເຂດ 9: 06118						
Ban Vungsa	Ban Vungmuang	Ban Namhang	Ban Phoupord						
ກີ່ວກະຈຳ 06120 - 06121						
ລະຫັດໄປສະນີ ເຂດ 1: 06120						
Ban Kiwkacham	Ban Phouthard	Ban Nongaon	Ban Kiwkharmporm						
Ban Phoudam	Ban Kiwtaloun 1	Ban Phakhaow	Ban Phasanin						
ລະຫັດໄປສະນີ ເຂດ 2: 06121						
Ban Namming	Ban Parksanarn	Ban Huayhaow	Ban Banlorng						
Ban Kiwtaloun 2 			 						
ນໍ້າຖ້ວມ 06130 - 06133						
ລະຫັດໄປສະນີ ເຂດ 1: 06130						
Ban Phonxieng	Ban Namthuam-tai	Ban Phonsawng	Ban Phaluang						
Ban Thabou	Namthuam-nuea	Ban Huana	Ban Huaykhuea						
Ban Namkharn	Ban Phonmanee	Ban Xiengda	 						
Ban Phonsavanth	Ban Xang	Ban Namkha	 						
ລະຫັດໄປສະນີ ເຂດ 2: 06131						
Ban Kiwha	Pongtai	Saenluang	Nongnuea						
ລະຫັດໄປສະນີ ເຂດ 3: 06132						
Ban Namnga	Ban Nae	Ban Huayhiem	Ban Naxiengdee						
Seemoungkhoun	Ban Huayhok	Ban Naham	Ban Phoukou						
Seebounhueang			 						
ມະຫາວິທະຍາໄລ ສຸພານຸວົງ						
ມະຫາວິທະຍາໄລ ສຸພານຸວົງ 06140 (ສະເພາະ ບໍລິເວນໂຮງຮຽນ)						




ແຂວງ ຫົວພັນ
ເລກລະຫັດໄປສະນີ 07000
ແຂວງຫົວພັນ 07xxx						
ເມືອງຊໍາເໜືອ ລະຫັດໄປສະນີ  07000 - 07005          						
ລະຫັດໄປສະນີ ເຂດ 1: 07000						
Ban Phanxay	Ban Xamnuea	Ban Na-arng	Ban Phoulon						
Ban	Ban Nathong	Ban Hardkork	Ban Phouluang						
Ban Navieng	Ban Naliw	Ban Khungkho	Ban Huaykho						
Ban Nasakarng	Ban Meesouk	Ban Khungkhaek	 						
Ban Nanongbua	Thardmueang 	Ban Huakhuang	 						
Ban Phonkham	Ban Phoxay	Nayerng+ Taao	 						
ລະຫັດໄປສະນີເຂດ 2: 07001          						
Ban Poung	Ban Sivilay	Ban Huazieng	Ban Huayhorm						
Ban Karn	Ban Tham	Ban Muan	 						
Ban Ngiw	Ban Aong	Ban Khungthee	 						
Ban Kor	Ban Kang	Ban Lou	 						
ລະຫັດໄປສະນີ ເຂດ 3: 07002          						
Ban Luk 12	Xangkham	Mueangvaen	Nakhar						
Ban Huayhindam	Naphieng	Phiengdy	Natarng						
Ban Luk 20	Mueangyorng	Phieng	Haotai						
Mueangharm- Ban Nuea	Nachong	Him	Haonuea						
Mueangharm-Tai	Nakham	Khod	Naduang						
Namueang	Phoxay	Tueam	Nayoung						
Done	Phiengkhung	Khong	Thuppherng						
Bun	Huaykhong	Huayyorng	Huaybuean						
Yard	Keokuang	Nakhoun	 						
ລະຫັດໄປສະນີ ເຂດ 4: 07003          						
Huayzorn	Tabong	Nanong	Nasamorng						
Huaypaek	Sahlei	Kangnam	Nasala						
Huaysarn	 	 	 						
ລະຫັດໄປສະນີ ເຂດ 5: 07004          						
Korhai	Huaythoum	Sopkar	Nam-aie						
Huaykai	Huaymar	Mueangyued	 						
ລະຫັດໄປສະນີ ເຂດ 6: 07005          						
Lorngauead	Sanaen	Lorngmao	Huayauang						
Pachayai	Na-ao	Aor	Huaphou						
Nazeng	Nongdaeng	Pachayai	 						
Norngkhang	khuadin	Phonsawang	 						
ເມືອງ ຊຽງຄໍ້ ລະຫັດໄປສະນີ  07010 - 07016 						
ລະຫັດໄປສະນີ ເຂດ 1: 07010						
Hup	Huaybaow	Phonna	Nongkieng						
Huaylang	Namueang	Nguam	Sopvan						
ລະຫັດໄປສະນີ ເຂດ 2: 07011         						
Huaymone	Phonthong	Huaypit	Kokxay						
Navieng	Sa-aorntai	Phiengyum	Sopmone						
ລະຫັດໄປສະນີ ເຂດ 3: 07012         						
Sopkoiy	Vungtung	Nakharm	Sopzaiy						
Soplorng	Phongxaiy		 						
ລະຫັດໄປສະນີ ເຂດ 4: 07013         						
Sopdoung	Naduea	Nanong	Phouk						
Xiengdaeng	Soppeen	Thaensarn	Natong						
ລະຫັດໄປສະນີ ເຂດ 5: 07014         						
Phienghome A	Khounkham	Sopsarn	Phienghome B						
Loup	Saer	Xiengkhor	 						
ລະຫັດໄປສະນີ ເຂດ 6: 07015       						
Phalorng	Keovaen	Thalard	Mongnam						
Poungsaed	 	 	 						
ລະຫັດໄປສະນີ ເຂດ 7: 07016						
Phiengsa	Nakhang	Chaefaiy	Pha-ao						
Korhai	 	 	 						
ເມືອງ ຮ້ຽມ ລະຫັດໄປສະນີ 07020 - 07024 						
ລະຫັດໄປສະນີ ເຂດ 1: 07020						
Nathuan	Thardhiem	Napuak	Namsard						
Navieng	Huaphu	Sumphunthong	 						
Thaemhing	Napho	Mueanghiem	 						
Phuvieng	Phiengdy	Huaysa	 						
ລະຫັດໄປສະນີ ເຂດ 2: 07021						
Khong	Pounghai	Phouluang	Poungpin						
Viengthong	Korkieng	Phoudarn 	Kang						
ລະຫັດໄປສະນີ ເຂດ 3: 07022						
Phonsa-ard	Donekhoun	Hardsa	Sakok						
Nampoung	 	 	 						
ລະຫັດໄປສະນີ ເຂດ 4: 07023						
Phonkham	Nalae	Khonengua	Phanlor						
Phiengdy	Sopmarn	 	 						
ລະຫັດໄປສະນີ ເຂດ 5: 07024						
Nakoud	Thamsa-tai	Thansa-nuea	 						
ເມືອງ ວຽງໄຊລະຫັດໄປສະນີ 07030 - 07038						
ລະຫັດໄປສະນີ ເຂດ 1: 07030          						
Viengxay	Phouxay	Vuk	Naveed						
Lorngkou	Nakai	Namueang	Phonxay						
Naluang	Xiengluang	Xiengzue	Phoumuead						
Nathaen	Hanglorng	Mueanglied	Chakhiep						
Mueangnga	Napoung	Sumphanxay	 						
ລະຫັດໄປສະນີ ເຂດ 2: 07031          						
Poungnakhaw	Nahia	Kangthard	Kangmong						
Namone	Khor	Kangmueang	Borpha						
Nakhaow	Phounkang	Xiengman	Nasarn						
Phounuea	Phongxang	Kaengpoung	Phounkao						
Phousarn	Phiengxay	Chaerfaiy	Phounmai						
ລະຫັດໄປສະນີ ເຂດ 3: 07032         						
Arnglung	Arngsung	Phiengchia	Arngthuan						
ລະຫັດໄປສະນີ ເຂດ 4: 07033          						
Phiengkhai	Hor	Ngiw	Darnxay						
Phiengkern	Kien	Soiy	 						
Nayang	Thaen	Darn	 						
ລະຫັດໄປສະນີ ເຂດ 5: 07034         						
Darnphao	Loun	Fard	Mueangpan						
Bor	Nachong	Muead	Vunghai						
Huaymuang	Ta-aen	Napho	 						
ລະຫັດໄປສະນີ ເຂດ 6: 07035         						
Chard	Sung	Banyaer	Nangua						
Natan	Vieng	Heo	Nafoung						
ລະຫັດໄປສະນີ ເຂດ 7: 07036						
Xieng	Nakuea	Namun	Hindam						
Dia	Naharm	Kamnang	Phuknga						
ລະຫັດໄປສະນີ ເຂດ 8: 07037						
Aern	Perm	Pork	 						
ລະຫັດໄປສະນີ ເຂດ 9: 07038						
Mueangpua	Naloung	Nazaeng	Pkonthong						
Namoaw          	Sard	Vungzaeng	Tong						
Nasa	Kaluen	Xiengkaem	Phienglieng						
Luanglao	Mun	 	 						
ເມືອງ ຫົວເມືອງ ລະຫັດໄປສະນີ 07040 - 07047 						
ລະຫັດໄປສະນີ ເຂດ 1: 07040						
Buamngam	Mueangperm	Nampong	Huazieng						
Khorng	 	 	 						
ລະຫັດໄປສະນີ ເຂດ 2: 07041 						
Parpaek	Lorngaung	Korhing	Soplarp						
Sarm	Phanang	Sonkhuar	Homethong						
Kung	Huakhai	Phiengdy	Namteep						
Vaek	Khungkhao	Huaymor	Homephan						
Phaow	Huaymoun	Taohin	 						
ລະຫັດໄປສະນີ ເຂດ 3: 07042         						
Keozeek	Mueangaor	Huayhu	Hongaoy						
Kang	Phukya	Phiengxay	 						
ລະຫັດໄປສະນີ ເຂດ 4: 07043         						
Aouthai	Songkhao	Korphouk	Namlaem						
Lorng	Sanord	Namu	Parchar						
Nangiw	 	 	 						
ລະຫັດໄປສະນີ ເຂດ 5: 07044						
Nalaeng	Homexaiy	Yordard	Parchar (bor)						
Namueang	Dong		 						
ລະຫັດໄປສະນີ ເຂດ 6: 07045         						
Phonkhung	Buaknuea	Buaktai	Phiengxang						
Korhai	Pakhatai	Hardkai	Thumlord						
Parkharnuea	Tham	Bor	Phienghome						
ລະຫັດໄປສະນີ ເຂດ 7: 07046         						
Thard	Homkuang	Sarmhuay	Parsord						
Nied	Salerd	Don	Saluang						
ລະຫັດໄປສະນີ ເຂດ 8: 07047          						
Soplao	Tardkai	Nokaen	Sophong						
Namnard	Huaymai	Larnxieng	Huaykham						
ເມືອງ ຊຳໃຕ້ ລະຫັດໄປສະນີ  07050 - 07058         						
ລະຫັດໄປສະນີ ເຂດ 1: 07050						
Phansavanth	Huaykik	Thin	Phattai						
Zamtai	Zamthong	Khor	Phatnuea						
Sarn	Lao	Phienghome	Phatkang						
Hanglorng	Naxieng	 	 						
ລະຫັດໄປສະນີ ເຂດ 2: 07051         						
Tao	Soppaen	Namtai	Phangam						
Phiengkhoun	Nakuea	Parpouk	 						
Naxay	Nambong	Parkhom	 						
ລະຫັດໄປສະນີ ເຂດ 3: 07052        						
Phiengthin	Phiengtung	Mueangkhan	Huayxaiy						
Sopkaem	Phiengmai		 						
ລະຫັດໄປສະນີ ເຂດ 4: 07053       						
Namard	Nangiw	Nahuen	Darn						
Soppeng	Khar	Poungban	Teenphu						
ລະຫັດໄປສະນີ ເຂດ 5: 07054          						
Paowtai	Phiengnuea	Dorkmai	Phahard						
Paownuea	Nalae	Namon	Teenpha						
Phueanuea	Mueangkien	Huaykhuak	 						
ລະຫັດໄປສະນີ ເຂດ 6: 07055          						
Hang	Mueangkern	korlou	Nahieng						
Natork	Thalao	Phulae	Thamchoke						
Kang	Naxeo	Naseekhamxay	Phalorm						
Phapherng			 						
ລະຫັດໄປສະນີ ເຂດ 7: 07056          						
Xiengban	Xiengkhoun	Xiengdy	Huaylard						
Aeed	Huaykhai	Nalar	Namain						
Bok	Hintung	Phonexay	Pormkhor						
ລະຫັດໄປສະນີ ເຂດ 8: 07057						
Pouk	Soptieng	Huaxieng	Thupkhor						
Kleoding	Parlao	Napho	Nornghaed						
ລະຫັດໄປສະນີ ເຂດ 9: 07058						
Huaymee	Thammou	Huaysadaep	Yordyueang						
Huana	Namtaep	Huaykoum	Namueang						
Huaysala	Huaypoung	Kaengnai	 						
ເມືອງ ແອດ ລະຫັດໄປສະນີ  07060 - 07065 						
ລະຫັດໄປສະນີ ເຂດ 1: 07060          						
Mueangaed	Phiengngern	Nayang	Nasarn						
Naha	Lu	Phienglu	Huaylom						
Mueangvun	Nalaeng	Xode	 						
Naheed	Kang	Yorng	 						
ລະຫັດໄປສະນີ ເຂດ 2: 07061          						
Chaefaiy	Nakueatai	Phathern	Kalung						
Namard	Hinkhoun	Nongxay	 						
Nakueanuea	Keohae	Parkha	 						
ລະຫັດໄປສະນີ ເຂດ 3: 07062          						
Kangnam-add	Supvaek	Nakhuang	Kharm						
Na	Katun	Parnor	Napoung						
Thamzorng	Nachapuang	Phapoun	Huayfork						
Naphieng	Phadaeng	Vungpo	Tamonh						
Lorngkeo	Mueangxuem	Lorngsim	Huaymor						
Huayvaek	Huaypuak	Nahong	 						
ລະຫັດໄປສະນີ ເຂດ 4: 07063						
Nakha	Nahome	Fukfan	Phakeo						
Daiy	Huaykork	Buampho	 						
Nangiw	Lornghoy	Namaen	 						
ລະຫັດໄປສະນີ ເຂດ 5: 07064						
Nahue	Nahoy	Naxao	Huayxaiy						
Nayom	Nangaer	Huaymen	 						
Nakai	Men	 	 						
ລະຫັດໄປສະນີ ເຂດ 6: 07065          						
Thaenluang	Bia	Phaer	Napa						
Darn	Xiengkhoun	Sor	 						
Huayku	Kang	Hardku	 						
ເມືອງ ສົບເບົາ ລະຫັດໄປສະນີ  07070 - 07076        						
ລະຫັດໄປສະນີ ເຂດ 1: 07070						
Sophaow	Nakhamhaow	Darnhung	Mueanghom						
Kanghaow	Sopbao	Nakhoun	Hardsun						
Naphonsouk	Lornghom	Nakhamhung	Pounghom						
Naxang	Darnhom	Nazorn	Haowsaen						
Phonxaiy	Mueanghung	Naphieng	Tard						
ລະຫັດໄປສະນີ ເຂດ 2: 07071						
Boh	Huaytoung	Mueangding	Phiengnga						
Pueng	Namhaeng	Nangua	 						
Nasuea	Napharm	Vienghung	 						
Bone	Phiengfueang	Talang	 						
ລະຫັດໄປສະນີ ເຂດ 3: 07072						
Phiengxay	Napueng	Phongbao	Porng						
Na	 	 	 						
ລະຫັດໄປສະນີ ເຂດ 4: 07073						
Naparn	Kanglorng	Korngkhoun	Nambong						
Nasoun	Khonesy	Home	Nayom						
Longngern	Mueanglorng	Nangon	 						
ລະຫັດໄປສະນີ ເຂດ 5: 07074						
Parhang	Phalorng	Huayngerm	Parkhompet						
Namterp	Parkhomnoy	Lorngtong	Muang						
Parkhomyai	Huaypa	Huayhieng	 						
ລະຫັດໄປສະນີ ເຂດ 6: 07075						
Naka	Phonxay	Na-aorn	Somwung						
ລະຫັດໄປສະນີ ເຂດ 7: 07076						
Khungkard	Phonhung	Namai	 						
ເມືອງ ຊ່ອນ ລະຫັດໄປສະນີ 07080 - 07084						
ລະຫັດໄປສະນີ ເຂດ 1: 07080						
Namnern	Lorngnguapa	Huaytuen	Phonzorng						
Buamfard	 	 	 						
ລະຫັດໄປສະນີ ເຂດ 1: 07081						
Nanom	Huayhorm	Huaymueay	Chak						
Thard	Zonenuea	Thonhnapor	Namor						
Vat	Laeng	Namngaow	 						
ລະຫັດໄປສະນີ ເຂດ 2: 07082						
Huaysangorn	Ngon	Nongsai	Huaylao						
Mun	Xorntai	Xaiy	Bor						
ລະຫັດໄປສະນີ ເຂດ 3: 07083						
Sarmsoum	Huysu	Mueangkao	Vungkhuang						
Huayyarm	 	 	 						
ລະຫັດໄປສະນີ ເຂດ 4: 07084						
Vungfaen	Mueangper	Soptiw	Bong						
Nakien	 	 	 						
ເມືອງ ກວັນ ລະຫັດໄປສະນີ 07090 - 07097 						
ລະຫັດປສະນີ ເຂດ 1: 07090						
Mueangkuan	Nongvaen	Poungxieng	Namkhuang						
Na-aor	Nonglao	Huayxaiy	 						
ລະຫັດໄປສະນີ ເຂດ 2: 07091						
Nanung	Hintung	Huayhai	Mar						
Phalaem	Phanthong	Daendin	Poungthark						
Korhai	Done	Tongaou	Huayvarn						
ລະຫັດໄປສະນີ ເຂດ 3: 07092
					
Sopkung	Phiengpho	Kaengkor	Phiengaorn						
Sanhome	Phiengdy	Sopsarn	Phiengxang						
ລະຫັດໄປສະນີ ເຂດ 4: 07093
					
Mueangyueang	Thamkhueang	Huaymaiy	Huayhaer						
Nahome	Phiengthard	Huayhong	Huaytha						
ລະຫັດໄປສະນີ ເຂດ 5: 07094						
Thakhoy	Yordpaow	Sunkhoun	Soumluang						
ລະຫັດໄປສະນີ ເຂດ 6: 07095						
Mueangna	Hinngerp	Parka	Nangorn						
Nathong	Yordbor	Korkhaiy	Huaymuang						
Huana	Lorngkuang	Navin	 						
ລະຫັດໄປສະນີ ເຂດ 7: 07096						
Parkhom	Poungwaii	Keokoud	Nakormue						
Huaybei	Huaypoung	Poungka	 						
Tungsao	Huayngua	Phalaem	 						
ລະຫັດໄປສະນີ ເຂດ 8: 07097
					
Buak	Nampard	Huayheng	Vitxaiy						
Korfoung	Huayjuen	 	 						
									
									
									
									
									






ແຂວງ ໄຊຍະບູລີ
ເລກລະຫັດໄປສະນີ 08000
ແຂວງໄຊຍະບູລີ 08xxx					
ເມືອງ ໄຊຍະບູລີ ລະຫັດໄປສະນີ  08000 - 08004          					
ລະຫັດໄປສະນີ ເຂດ 1: 08000					
Thana	Kaeng	Nongxaeng	Nayaotai					
Pong	Boung	Natornoy	Nayaonuea					
Symoungkhoun	Donemai	Natoryai	Nahai					
Symueang	Donengern	Lorngpor	 					
Thin	Yai 	Nonsavanh	 					
Phapoun	Nalao	Nala	 					
ລະຫັດໄປສະນີ ເຂດ 2: 08001          					
Nathung	Phiengbon	Huaylerk	Nalaengnoy					
Namtuan	Huaykaeng	Huayzamaor	Wunghin					
Namliep	Huayzui	Suan	Nara					
Phonxay luk 18	Huaysaenkham	Vungzoy	 					
Huayduea	Huaydok	Nalaengluang	 					
ລະຫັດໄປສະນີ ເຂດ 3: 08002          					
Phonkeo	Thamlord	Parkpa	Huaychit					
Nakhoun	Thaduea	Huaythard	Parklaep					
Pangcom	Parkphai	Talarn	 					
ລະຫັດໄປສະນີ ເຂດ 4: 08003          					
Natark	Huayzaow	Huayloun	Nazo					
Nalek	Nangiw	Nongnong	Namthiew					
Thardhorm	Nakhan	Namone	Namkah					
Parkzaow	Vungdin	Lorngxaeng	 					
ລະຫັດໄປສະນີ ເຂດ 5: 08004          					
Huayphuan	Huayphoc	Khonepied	Nakuang					
Huaysangaem	Huaylei	 	 					
ເມືອງ ພຽງ ລະຫັດໄປສະນີ  08010 - 08014         					
ລະຫັດໄປສະນີ ເຂດ 1: 08010					
Mueangphieng	Saengchalern	Kang	Namhia					
Phonxay	Dongngern	Phonsawang	Somsavanth					
Phonhin	dongluang	Nakork	Nampungmuean					
Nongngua	 	 	 					
ລະຫັດໄປສະນີ ເຂດ 2: 08011          					
Kiwkhaem	Dontiw	Pongvang	Huayxark					
Namsong	 	 	 					
ລະຫັດໄປສະນີ ເຂດ 3: 08012          					
Nongbuaphinong	Natarn	Nongbuaxaiy	Nongbuathong					
Sybounhueang	Naxing	Phonxieng	Huana					
Nasome	Nabuam	 	 					
ລະຫັດໄປສະນີ ເຂດ 4: 08013          					
Nakhaem	Vangkham	Viengchalern	Phadam					
Nanonghoung	Huayaoung	Nampui	Namyarp					
ລະຫັດໄປສະນີ ເຂດ 5: 08014          					
Parkxorng	Namor	Vangkham	Phonthong					
Navaen	Namphone	Phonsa-ard	Nakorng					
Namliep	Huayharn	Somsavath	Phonsak					
Khounphone	Nalae	Na-aoum	Homexay					
ເມືອງ ປາກລາຍ ລະຫັດໄປສະນີ  08020 - 08027         					
ລະຫັດໄປສະນີ ເຂດ 1: 08020					
                                                                                                                                                                                                                                                       	Nasawang	Vungthoum	Xayyamoungkhoun					
Hualaiynooy	Pangkham	Huayxaiykham	Nasak					
Saenglaiy	Pongkhor	Ban Sysa-ardxomphou	Kaengsaow					
Sysawang	 	 	 					
ລະຫັດໄປສະນີ ເຂດ 2: 08021          					
Boungma	Huaytarng	Parklaeng	Huaydueawarn					
Tarkdaed	Huayhai	Dongsanguan	Sivilay					
ລະຫັດໄປສະນີ ເຂດ 3: 08022          					
ບ້ານ ມ່ວງເໜືອ	ບ້ານ ມ່ວງໃຕ້	ບ້ານ ແຄ	ບ້ານ ດອນ					
ລະຫັດໄປສະນີ ເຂດ 4: 08023          					
ບ້ານ ເມືອງວາ	ບ້ານ ນາຄໍາ	ບ້ານ ທ່າມີໄຊ	ບ້ານ ນາແຊງ					
ບ້ານ ບົວບານ	ບ້ານ ນາໃໝ່	ບ້ານ ໂຄກສະທ້ອນ	ບ້ານ ຫ້ວຍຊາຍຂາວ					
ບ້ານ ປົ່ງຫວານ	ບ້ານ ຫ້ວຍມົດສົ້ມ	ບ້ານ ໂພນ	 					
ລະຫັດໄປສະນີ ເຂດ 5: 08024         					
ບ້ານ ສຸວັນນະພູມ	ບ້ານ ປາງຄໍາ	ບ້ານ ທ່ານາ	ບ້ານ ໂພນໄຊ					
ບ້ານ ນາກາງ	ບ້ານ ກາງ	ບ້ານ ທ່າປໍ	ບ້ານ ນໍ້າລິນ					
ລະຫັດໄປສະນີ ເຂດ 6: 08025          					
ບ້ານ ຜາແກ້ວ	ບ້ານ ແສນພົນ	ບ້ານ ນໍ້າຍາງ	ບ້ານ ຫ້ວຍຄວາຍ					
ບ້ານ ບວມເລົາ	ບ້ານ ລາດສະຫ່ວາງ	ບ້ານ ຫ້ວຍເຫລັກ	ບ້ານ ວັງຍາວ					
ບ້ານ ປ່າໄລ່	ບ້ານ ຂອນແກ່ນ	ບ້ານ ປອນຂ້າມ	 					
ລະຫັດໄປສະນີ ເຂດ 7: 08026          					
ບ້ານ ຫ້ວຍຍູງ	ບ້ານ ນາຈັນ	ບ້ານ ປາກຄານ	ບ້ານ ໜອງໄຄ					
ບ້ານ ເມືອງປາ	ບ້ານ ນາຄານ	ບ້ານ ປາກຕຸງ	ບ້ານ ຜາລຽບ					
ບ້ານ ນໍ້າປາ	ບ້ານ ນາຕຸງ	 	 					
ລະຫັດໄປສະນີ ເຂດ 8: 08027         					
ບ້ານ ວັງພະໜອນ	ບ້ານ ໂພນງາມ	ບ້ານ ນາຕ້າ	ບ້ານ ນາໂພ					
ບ້ານ ນາຄະຍາງ	ບ້ານ ຫາດດ້າຍ	 	 					
ເມືອງ ແກ່ນທ້າວ ລະຫັດໄປສະນີ  08030 - 08034        					
ລະຫັດໄປສະນີ ເຂດ 1: 08030					
ບ້ານ ຈອມແກ້ວ	ບ້ານ ເມືອງເກົ່າ	ບ້ານ ພວນ	ບ້ານ ນາບອນ					
ບ້ານ ຈອມເພັດ	ບ້ານ ທ້າວແກ່ນ	ບ້ານ ຫາດແດງ	 					
ລະຫັດໄປສະນີ ເຂດ 2: 08031          					
ບ້ານ ຫ້ວຍຕໍ	ບ້ານ ຄອນຕະປູ	ບ້ານ ສາມຊົ້ງ	ບ້ານ ດົງສາມແສນ					
ບ້ານ ເມືອງໝໍ	ບ້ານ ໂພນສະຫ່ວາງ	ບ້ານ ກົກກະບົກ	ບ້ານ ກ້ວຍແຂ້					
ບ້ານ ນາແກ້ງມາ	ບ້ານ ນາຫີນ	 	 					
ລະຫັດໄປສະນີ ເຂດ 3: 08032          					
ບ້ານ ປາກຕົມ	ບ້ານ ຫ້ວຍຄາ	ບ້ານ ນໍ້າເຕົ້າ	ບ້ານ ກົກກະທອນ					
ບ້ານ ປາກແຄມ	ບ້ານ ຫ້ວຍປາກທ່າ	ບ້ານ ໜອງ	ບ້ານ ກົກໄຮຄໍາ					
ບ້ານ ຫ້ວຍເຮັຍ	ບ້ານ ຫົວຂົວ	ບ້ານ ໂພນປາກປໍ	ບ້ານ ປົງແດງ					
ລະຫັດໄປສະນີ ເຂດ 4: 08033          					
ບ້ານ ກຸ້ມສ້ຽວ	ບ້ານ ວັງປາ	ບ້ານ ຫ້ວຍປູຮາ	ບ້ານ ຫ້ວຍເປັດ					
ບ້ານ ຫ້ວຍເລີກ	ບ້ານ ສວນກ້ວຍ	ບ້ານ ລາດຂາມ	ບ້ານ ຫ້ວຍຫລອດ					
ບ້ານ ວັງປູນ	 	 	 					
ລະຫັດໄປສະນີ ເຂດ 5: 08034          					
ບ້ານ ດອນເມນ	ບ້ານ ນາຄູນ	ບ້ານ ຫ້ວຍລ້າ	ບ້ານ ປຸ່ງຄ້າ					
ບ້ານ ນາຄູນ	ບ້ານ ນາຄຳ	ບ້ານ ເວີນຄໍາ	ບ້ານ ຫ້ວຍອີ່ຮຸ່ນ					
ບ້ານ ແຄ	ບ້ານ ດອນສັ້ງ	 	 					
ເມືອງ ບໍ່ແຕນ ລະຫັດໄປສະນີ 08040 - 08044         					
ລະຫັດໄປສະນີ ເຂດ 1: 08040					
ບ້ານ ນາກອກ	ບ້ານ ຕາລີ່ງ	ບ້ານ ເມືອງຮໍາ	ບ້ານ ຫ້ວຍຕາປູ່					
ບ້ານ ນາສ້ານ	ບ້ານ ໂພນໄຊ	ບ້ານ ນາຫົວຊ້າງ	 					
ລະຫັດໄປສະນີ ເຂດ 2: 08041          					
ບ້ານ ໃຫຍ່	ບ້ານ ເຕົາເກືອ	ບ້ານ ນາຂ່າ	ບ້ານ ທ່ານາ					
ບ້ານ ດອນສະຫວ່າງ	ບ້ານ ບໍ່ແຕນ	ບ້ານ ໜອງຜັກບົ້ງ	 					
ລະຫັດໄປສະນີ ເຂດ 3: 08042          					
ບ້ານ ບໍ່ສ້ານ	ບ້ານ ນາບໍ່ນ້ອຍ	ບ້ານ ບໍ່ຫາງນາ	ບ້ານ ເໝື໊ອງແພ່					
ບ້ານ ຕົ້ນຕານ	 	 	 					
ລະຫັດໄປສະນີ ເຂດ 4: 08043          					
ບ້ານ ນໍ້າພຸ	ບ້ານ ນາເມືອງ	ບ້ານ ນາບົງໃຕ້	ບ້ານ ນາບົງເໜືອ					
ບ້ານ ນໍ້າດັ້ນ	 	 	 					
ລະຫັດໄປສະນີ ເຂດ 5: 08044          					
ບ້ານ ໜອງປະຈິດ	ບ້ານ ນາແລ້ງ	ບ້ານ ໜອງໃຫຍ່	ບ້ານ ໂພນໄຊ					
ບ້ານ ກຸ່ມ	 	 	 					
ເມືອງ ຫົງສາ ລະຫັດໄປສະນີ  08050 - 08054        					
ລະຫັດໄປສະນີ ເຂດ 1: 08050					
ບ້ານ ໂພນໄຊ	ບ້ານ ໂພນສະອາດ	ບ້ານ ດອນໄຊ	ບ້ານ ສີມູງຄູນ					
ບ້ານ ໂພນສູງ	ບ້ານ ສີບຸນເຮືອງ	ບ້ານ ຈອມແຈ້ງ	 					
ລະຫັດໄປສະນີ ເຂດ 2: 08051         					
ບ້ານ ຈໍາປາ	ບ້ານ ນາສ້ານ	ບ້ານ ໂພນຈັນ	ບ້ານ ນໍ້າລິບ					
ບ້ານ ວຽງແກ້ວ	ບ້ານ ນາໄມ້ຍົມ	ບ້ານ ພູຕຸ້ມ	ບ້ານ ຫານ					
ລະຫັດໄປສະນີ ເຂດ 3: 08052         					
ບ້ານ ນາໜອງຄຳ	ບ້ານ ນາຊາຍຄຳ	ບ້ານ ນໍ້ເລືອກ	ບ້ານ ກີ່ວມ່ວງ					
ລະຫັດໄປສະນີ ເຂດ 4: 08053         					
ບ້ານ ນໍ້າແກນ	ບ້ານ ແທ່ນ	ບ້ານ ຫ້ວຍເຍີ	ບ້ານ ນໍ້າຕົບ					
ລະຫັດໄປສະນີ ເຂດ 5: 08054         					
ບ້ານ ນາປຸ່ງ	ບ້ານ ໜອງຫລວງ	ບ້ານ ກີ່ວງີ້ວ	ບ້ານ ພູແລ້ງ					
ເມືອງ ຊຽງຮ່ອນ ລະຫັດໄປສະນີ  08060 - 08064         					
ລະຫັດໄປສະນີ ເຂດ 1: 08060					
ບ້ານ ທາດ	ບ້ານ ແກ່ນ	ບ້ານ ປ່າຫ້ວານ	ບ້ານ ດອນໃຈ					
ບ້ານ ໃໝ່	ບ້ານ ດອນເຟືອງ	ບ້ານ ກວງ	ບ້ານ ຄໍ້າ					
ບ້ານ ຊ້າງ	ບ້ານ ດອນຕັນ	ບ້ານ ລັບ	ບ້ານ ຄີງ					
ລະຫັດໄປສະນີ ເຂດ 2: 08061          					
ບ້ານ ປົ່ງ	ບ້ານ ສີນົກໄຊ້	ບ້ານ ນໍ້າລ້ອມ	ບ້ານ ຫ້ວຍຕ້ອງ					
ບ້ານ ກາບ	ບ້ານ ພູລ້ານ	ບ້ານ ແກສີພັນ	ບ້ານ ນໍ້າເປີງ					
ບ້ານ ປົ່ງແປ້ນ	ບ້ານ ນໍ້າຄອນ	ບ້ານ ຫ້ວຍຮາກ	 					
ລະຫັດໄປສະນີ ເຂດ 3: 08062          					
ບ້ານ ລາດສະໂນ	ບ້ານ ຫົວນາ	ບ້ານ ນໍ້າກອກ	ບ້ານ ຫົວເມືອງ					
ບ້ານ ນາອອມ	ບ້ານ ສາມັກຄີໄຊ	ບ້ານ ດອນມູນ	ບ້ານ ດ່ານໃໝ່					
ລະຫັດໄປສະນີ ເຂດ 4: 08063         					
ບ້ານ ປາກປິດ	ບ້ານ ຮ່ອງຄູ່	ບ້ານ ຫ້ວຍຄູນ	ບ້ານ ນໍ້າແບ່ງ					
ບ້ານ ໂຮມໄຊ	 	 	 					
ລະຫັດໄປສະນີ ເຂດ 5: 08064          					
ບ້ານ ມົກສະຕູ	ບ້ານ ຫ້ວຍຍວກ	ບ້ານ ດອນໄຊ	ບ້ານ ນໍ້າແປ					
ບ້ານ ດົງ	ບ້ານ ຫ້ວຍເຄັງ	 	 					
ເມືອງ ເງີນ ລະຫັດໄປສະນີ  08070 - 08072          					
ລະຫັດໄປສະນີ ເຂດ 1: 08070					
ບ້ານແກ້ວດອນຄູນ	ບ້ານ ຂອນ	ບ້ານ ບີໝີ	ບ້ານ ນໍ້າເງີນ					
ບ້ານ ຫລວງມີໄຊ	ບ້ານ ເພຍງາມ	ບ້ານ ກາງ	ບ້ານ ນາງົວ					
ລະຫັດໄປສະນີ ເຂດ 2: 08071          					
ບ້ານ ນາຢາງ	ບ້ານ ຫ້ວຍຜີ້ງ	ບ້ານ ປາງປົ່ງ	ບ້ານ ປຸ່ງຝາດ					
ບ້ານ ດອນຄໍາ	ບ້ານ ດອກເກດ	 	 					
ລະຫັດໄປສະນີ ເຂດ 3: 08072          					
ບ້ານ ດອກສະຫວ່າງ	ບ້ານ ຜາແດງ	ບ້ານ ປາກແຄມ	ບ້ານ ກີ່ວງີ້ວ					
ບ້ານ ນໍ້າທົນ	ບ້ານ ໂຮມໄຊ	ບ້ານ ຫ້ວຍເຫງີຍ	ບ້ານ ບໍຫລວງ					
ບ້ານ ທອງ	 	 	 					
ເມືອງ ຄອບ ລະຫັດໄປສະນີ  08080 - 08084         					
ລະຫັດໄປສະນີ ເຂດ 1: 08080					
ບ້ານ ຜາປອງ	ບ້ານ ສະຖານ	ບ້ານ ນໍ້າຟ້າວ	ບ້ານ ເຄີ່ງເຫລັກ					
ລະຫັດໄປສະນີ ເຂດ 2: 08081          					
ບ້ານ ມ່ວງດອນມູນ	ບ້ານ ໂພນສະຫວ່າງ	ບ້ານ ຫົວເມືອງ	ບ້ານ ເຫລັ້ມ					
ລະຫັດໄປສະນີ ເຂດ 3: 08082          					
ບ້ານ ຖໍ້າ	ບ້ານ ນໍ້າຄ່າ	ບ້ານ ປາງໄຮ	ບ້ານ ດອນຍົມ					
ບ້ານ ທົ່ງເໝັ້ນ	ບ້ານ ປ່າງຊາງ	ບ້ານ ປ່າຄ່າ	ບ້ານ ປາງມອນ					
ລະຫັດໄປສະນີ ເຂດ 4: 08083         					
ບ້ານ ຫ້ວຍນົກກົດ	ບ້ານ ບໍ່	ບ້ານ ປາກຄອບ	ບ້ານ ດອນແຮ່					
ບ້ານ ຫ້ວຍເລົາ	ບ້ານ ຫາດງາມ	ບ້ານ ດອນຕັນ	 					
ລະຫັດໄປສະນີ ເຂດ 5: 08084         					
ບ້ານ ຄົກເນີຍ	ບ້ານ ໃຈສະຫວ່າງ	ບ້ານ ຫ້ວຍເຊີນ	ບ້ານ ນໍ້າໂຕ່ມ					
ເມືອງ ທົ່ງມີໄຊ ລະຫັດໄປສະນີ  08090 - 08092        					
ລະຫັດໄປສະນີ ເຂດ 1: 08090					
ບ້ານ ໃຫຍ່	ບ້ານ ທາດ	ບ້ານ ມູນ	 					
ລະຫັດໄປສະນີ ເຂດ 2: 08091          					
ບ້ານ ດ່ານ	ບ້ານ ນາໝອກ	ບ້ານ ນາມົນ	ບ້ານ ນາເປື່ອຍ					
ບ້ານ ແຄ່ນ	 	 	 					
ລະຫັດໄປສະນີ ເຂດ 3: 08092          					
ບ້ານ ນາມ່ວງ	ບ້ານ ນາຜາຍ	ບ້ານ ໃໝ່	ບ້ານ ນາສະຫ່ວາງ					
ບ້ານ ແດດ	 	 	 					
ເມືອງ ໄຊສະຖານ ລະຫັດໄປສະນີ 08100 - 08101					
ລະຫັດໄປສະນີ ເຂດ 1: 080100					
ບ້ານສັນແຕ	ບ້ານ ສະເຂດ	ບ້ານ ພູເລີ່ນ	ບ້ານ ກໍ່ໃຫຍ່					
ບ້ານ ສະແມດໃຫຍ່	ບ້ານ ກ້ອງທ່ຽງ	ບ້ານ ກີ່ວກອກ	ບ້ານ ກີ່ວເປາະ					
ບ້ານ ສະແມດນ້ອຍ	ບ້ານ ດອຍກາວ	ບ້ານ ສາລາ	ບ້ານ ສະປິ					
ລະຫັດໄປສະນີ ເຂດ 2: 08101					
ບ້ານມີໄຊ	ບ້ານ ສາມັກຄີໄຊ	ບ້ານ ສະຖານ	ບ້ານ ເສົາດ່ຽວ					
ບ້ານ ປາກລອງ	ບ້ານ ສີສາຍທອງ	ບ້ານ ສະມະ	ບ້ານ ພູຕຸ່ຍ					
 								
								
								
								
								
								
								
								



								
								












ແຂວງ ຊຽງຂວາງ
ເລກລະຫັດໄປສະນີ 09000
ແຂວງ ຊຽງຂວາງ 09xxx			
ເມືອງ ແປກລະຫັດໄປສະນີ  09000 - 09006          			
ລະຫັດໄປສະນີເຂດ 1: 09000			
ບ້ານ ວຽງຄວນ	ບ້ານ ນາຟ້າ	ບ້ານ ດູ່ຊາງ	ບ້ານ ລາດບວກ			
ບ້ານ ວຽງ	ບ້ານ ຫຍາບສີ	ບ້ານ ໝີ່	ບ້ານ ເປີບ			
ບ້ານ ນາຄວນ	ບ້ານ ໂພນສີ	ບ້ານ ສີເມືອງ	ບ້ານ ຍອດປຽງ			
ບ້ານ ຫວ້ານ	ບ້ານ ມອນ	ບ້ານ ນາເພີງ	ບ້ານ ໂພນ			
ລະຫັດໄປສະນີ ເຂດ 2: 09001          			
ບ້ານ ລາວທອງ	ບ້ານ ໝ້ຽງນາລາມ	ບ້ານ ຄັງວຽງ	ບ້ານ ໝັ້ນຊົມ			
ບ້ານ ສີຄູນ			 			
ລະຫັດໄປສະນີ ເຂດ 3: 09002			
ບ້ານ ຄັງຍາວ	ບ້ານ ໂຕນເໜືອ	ບ້ານ ນໍ້າຕົ້ມ	ບ້ານ ນານູ			
ບ້ານ ນາໂອ	ບ້ານ ໂຕນໄຕ້	ບ້ານ ລາດຮ້ວງ	 			
ລະຫັດໄປສະນີ ເຂດ 4: 09003			
ບ້ານ ຍອດງື່ມ	ບ້ານ ນ້ຳເກາະ	ບ້ານ ນາສາລາ	ບ້ານ ນ້ຳຄະ			
ບ້ານ ອໍ້ອັ່ນ	ບ້ານ ຄາຍ	ບ້ານ ພູສັນ	ບ້ານ ແກ່ວ			
ບ້ານ ເມືອງນ້ອຍ	ບ້ານ ປ່າຂົມ	ບ້ານ ນາຄຳແພງ	ບ້ານ ວຽງໄຊ			
ບ້ານ ໂພນຄຳ	ບ້ານ ບວກກົບ	ບ້ານ ຊວ້ານ	ບ້ານ ຜາແກ້ວ			
ບ້ານ ຍວນທອງ	ບ້ານ ມວນ	ບ້ານ ຕ້າ	ບ້ານ ທ່າໂຈກ			
ລະຫັດໄປສະນີ ເຂດ 5: 09004			
ບ້ານ ນາເຮືອງ	ບ້ານ ນາເທົາ	ບ້ານ ຫ້ວຍສັ້ງ	ບ້ານ ຄັງໜອງຫຼວງ			
ບ້ານ ນາດີ	ບ້ານ ອ່າງ	ບ້ານ ນາຫອຍ	ບ້ານ ພູເກັງ			
ບ້ານ ລາດງ່ອນ	ບ້ານ ນາຄູນ	ບ້ານ ມ່ວງພາ	 			
ລະຫັດໄປສະນີ ເຂດ 6: 09005			
ບ້ານ ສີ	ບ້ານ ນາຊູ	ບ້ານ ພັ້ນ	ບ້ານ ຄອງ			
ບ້ານ ໂພນໄຊ	ບ້ານ ໜອງ	ບ້ານ ນາ	ບ້ານ ວຽງທອງ			
ບ້ານ ພູຮຸ້ມ	ບ້ານ ໝີ່	ບ້ານ ວຽງຄຳ	ບ້ານ ປຸ່ງແວນ			
ລະຫັດໄປສະນີ ເຂດ 7: 09006			
ບ້ານ ຄູ	ບ້ານ ໂພນສະຫວັນໄຊ	ບ້ານ ໂພນສະອາດໃຕ້	ບ້ານ ລີ			
ບ້ານ ວຽງ	ບ້ານ ບີ້	ບ້ານ ດ່ອງ	ບ້ານ ໂພນງາມໃຕ້			
ບ້ານ ມອນ	ບ້ານ ໂພນສະຫວ່າງ	ບ້ານ ໂພນມີໄຊ	ບ້ານ ໂພນຄຳ			
ບ້ານ ນາພົງ	ບ້ານ ຢອນ	ບ້ານ ໂງຍ	ບ້ານ ໂພນທອງ			
ບ້ານ ຄັງໄຂ	ບ້ານ ເທີນ	ບ້ານ ນ້ຳຫງຳ	ບ້ານ ສາຍລົມ			
ບ້ານ ຮົວະ	ບ້ານ ຍວນ	ບ້ານ ສີໂພນໄຊ	ບ້ານ ນ້ຳເສິງ			
ບ້ານ ໂພນສະຫວັນເໜືອ	ບ້ານ ໂພນສະຫວັນໃຕ້	ບ້ານ ທົ່ງມີໄຊ	ບ້ານ ໜອງແຮນ			
ບ້ານ ໂພນສະຫວັນກາງ	ບ້ານ ໂພນສະອາດເໜືອ	ບ້ານ ເຫຼັກ	ບ້ານ ໂພນງາມເໜືອ			
ເມືອງ ຄຳ ລະຫັດໄປສະນີ 09010 - 09016 			
ລະຫັດໄປສະນີ ເຂດ 1: 09010			
ບ້ານ ຈອມທອງ	ບ້ານ ມ່ວງໄຊ	ບ້ານ ໂພໄຊ	ບ້ານ ພຽງດີ			
ບ້ານ ບານ	ບ້ານ ນາທອງໄຄ້ວຽງ	ບ້ານ ວຽງຄຳ	ບ້ານ ຮວດ			
ບ້ານ ຕອງ	ບ້ານ ຊຽງກ່ຽວ	ບ້ານ ນາເມືອງ	ບ້ານ ນາຍອງ			
ບ້ານ ສັນ	ບ້ານ ນາຕູມ	ບ້ານ ດອກຄຳ	ບ້ານ ແງ້ວ			
ບ້ານ ຫີນ	ບ້ານ ສັນພັນ	ບ້ານ ລາດນົບ	ບ້ານ ຄັງແຄະ			
ບ້ານ ກວ້າຍ	ບ້ານ ຊົມ	ບ້ານ ກໍງິ້ວ	ບ້ານ ໄຮ່ໝ່ຽງ			
ບ້ານ ຊາງ	ບ້ານ ຈອມສີ	ບ້ານ ຍຸ້ມຈອງ	ບ້ານ ຜາທ້າງ			
ບ້ານ ດຸ່ງຄຳ	ບ້ານ ລ້ອງປີວ	ບ້ານ ໂພນຄຳ	ບ້ານ ນ້ຳຮົ່ມ			
ບ້ານ ຕາດ	ບ້ານ ແລະນາດໍ່	ບ້ານ ບົວ	ບ້ານ ຫ້ວຍພັດ			
ບ້ານ ນາເໝືອຍ	ບ້ານ ແລ້ງ	ບ້ານ ນາອຸງ	 			
ບ້ານ ຊາມ	ບ້ານ ຊາຍນາດູ່	ບ້ານ ຮີບ	 			
ບ້ານ ຍອດເກື້ອ	ບ້ານ ໃໝ່ກໍຄາຍ	ບ້ານ ຖາງ	 			
ລະຫັດໄປສະນີ ເຂດ 2: 09011         			
ບ້ານ ໂພສີ	ບ້ານ ນາພຽງ	ບ້ານ ໂພນທັນ	ບ້ານ ໂພໄຊ			
ລະຫັດໄປສະນີ ເຂດ 3: 09012			
ບ້ານ ນາພັນ	ບ້ານ ສຳພັນໄຊ		 			
ລະຫັດໄປສະນີ ເຂດ 4: 09013			
ບ້ານ ຍອດປຽດ	ບ້ານ ໂພຂາມ	ບ້ານ ຜາຫານ	ບ້ານ ໂພນໂຮມ			
ບ້ານ ນ້ຳທຸ້ມ	ບ້ານ ຜາກອກ	ບ້ານ ໂພນແຈ້ງ	 			
ລະຫັດໄປສະນີ ເຂດ 5: 09014			
ບ້ານ ນ້ຳຈາກ	ບ້ານ ນາໄຊ	ບ້ານ ສົບອໍ້	ບ້ານ ນາມວນ			
ບ້ານ ທ່າ	ບ້ານ ບວມພຽງ	ບ້ານ ນາຫຼວງ	 			
ລະຫັດໄປສະນີ ເຂດ 6: 09015			
ບ້ານ ສວນມອນ	ບ້ານ ສອງ	ບ້ານ ວຽງ	ບ້ານ ຫາດຄຳ			
ບ້ານ ນ້ຳລ້ຽງ	ບ້ານ ສູມແມນ	ບ້ານ ຫ້ວຍຫອນ	ບ້ານ ແກ່ວເຮືອ			
ບ້ານ ໜອງໂອນ	ບ້ານ ພູຫີນ	ບ້ານ ສັນຄຳ	ບ້ານ ວັງຊົງ			
ບ້ານ ແກ່ວເລິກ	ບ້ານ ສັນແຟນ	ບ້ານ ສັນໂພ	 			
ລະຫັດໄປສະນີ ເຂດ 7: 09016			
ບ້ານ ແທ່ນໂທ້	ບ້ານ ກາງຄຳ	ບ້ານ ສົບນາ	ບ້ານ ສັນແກ້ວ			
ບ້ານ ແທ່ນຈອງ	ບ້ານ ພຽງດ້າງ	ບ້ານ ສົບເປີນ	 			
ບ້ານ ພຽງໂຄ້ງ	ບ້ານ ສົບທ້າງ	ບ້ານ ພຽງພ່າງ	 			
ເມືອງ ຄູນ ລະຫັດໄປສະນີ 09020 - 09028			
ລະຫັດໄປສະນີ ເຂດ 1: 09020			
ບ້ານ ເມືອງ	ບ້ານ ນາດີ	ບ້ານ ຢ້ຽມ	ບ້ານ ຊຳກວ້າງ			
ບ້ານ ສີຊຽງໃໝ່	ບ້ານ ຫີນໂງ່ນ	ບ້ານ ຢ່ຽນ	ບ້ານ ຖ້ຳຫົວເຫຼົ່າ			
ບ້ານ ເປີນ	ບ້ານ ນາຮອນ	ບ້ານ ພູວຽງ	 			
ລະຫັດໄປສະນີ ເຂດ 2: 09021			
ບ້ານ ຜາເຜິ້ງ	ບ້ານ ສັນຫຼວງ	ບ້ານ ແກ່ວກວ້າງ	ບ້ານ ໜອງ			
ບ້ານ ພູກາເຟ			 			
ລະຫັດໄປສະນີ ເຂດ 3: 09022			
ບ້ານ ແທ່ນພູນ	ບ້ານ ຫ້ວຍລຸນ	ບ້ານ ແທ່ນທອງ	ບ້ານ ແກ່ວເລິກ			
ບ້ານ ຄາບ	ບ້ານ ນ້ຳລັນ	ບ້ານ ຜາຂາວ	 			
ລະຫັດໄປສະນີ ເຂດ 4: 09023			
ບ້ານ ພູມະເມືອງ	ບ້ານ ນາລາມ	ບ້ານ ສັນຄີງ	ບ້ານ ໜອງຫຼວງ			
ບ້ານ ຊຳຍຸງ	ບ້ານ ນາທອງ	ບ້ານ ອົ້ມ	 			
ລະຫັດໄປສະນີ ເຂດ 5: 09024			
ບ້ານ ດອກໄມ້	ບ້ານ ເຄັກ	ບ້ານ ນາພະສາດ	ບ້ານ ນາເມືອງ			
ບ້ານ ສີບຸນເຮືອງ	ບ້ານ ນາສົມ	ບ້ານ ສີວຽງຄຳ	ບ້ານ ນາບົງ			
ລະຫັດໄປສະນີ ເຂດ 6: 09025			
ບ້ານ ສີພົມ	ບ້ານ ນາຮໍ້	ບ້ານ ທຸ້ມ	ບ້ານ ໄຜ່			
ບ້ານ ນາສີ	ບ້ານ ຫ້ວຍແຈະ	ບ້ານ ນາໄຊ	 			
ບ້ານ ນາໂພ	ບ້ານ ຊ້າງ	ບ້ານ ເພຍວັດ	 			
ບ້ານ ໂພນແຍງ	ບ້ານ ນາອູ່	ບ້ານ ໂພສີ	 			
ລະຫັດໄປສະນີ ເຂດ 7: 09026			
ບ້ານ ຫອຍ	ບ້ານ ບົວເໜືອ	ບ້ານ ບົວໄຕ້	ບ້ານ ໜອງຜື			
ບ້ານ ນາຕໍ	ບ້ານ ຖ້ຳ	ບ້ານ ກົ້ວ	 			
ບ້ານ ໜອງນ້ຳ	ບ້ານ ທົ່ງ	ບ້ານ ຍຸນໄຊຊະນະ	 			
ບ້ານ ໂພນໄຊ	ບ້ານ ດົງດ່ານ	ບ້ານ ນາຈັນ	 			
ລະຫັດໄປສະນີ ເຂດ 8: 09027			
ບ້ານ ແກ່ວແສດ	ບ້ານ ພັກຮິ້ງ	ບ້ານ ຕັນໃຕ້	ບ້ານ ຕັນເໜືອ			
ບ້ານ ປຽງ			 			
ລະຫັດໄປສະນີ ເຂດ 9: 09028			
ບ້ານ ນ້ຳພານ	ບ້ານ ປ່າຄາ	ບ້ານ ຄັງໂຮງ	ບ້ານ ຫ້ວຍຫົກ			
ບ້ານ ທ່າລິນ	ບ້ານ ພັກຊົວະ	ບ້ານ ຜ່າເຫຼື້ອມ	 			
ເມືອງ ໜອງແຮດ ລະຫັດໄປສະນີ 09030 - 09039; 090101 			
ລະຫັດໄປສະນີ ເຂດ 1: 09030			
ບ້ານ ຖ້ຳໄຊ	ບ້ານ ໜອງຂຽວ	ບ້ານ ພັກຫຼັກ	ບ້ານ ໜອງຊາງ			
ບ້ານ ໜອງແຮດເໜືອ	ບ້ານ ນ້ຳກວາງ		 			
ລະຫັດໄປສະນີ ເຂດ 2: 09031			
ບ້ານ ໜອງແຮດໃຕ້	ບ້ານ ດິນດຳ	ບ້ານ ຫ້ວຍເດື່ອ	ບ້ານ ນາເມືອງ			
ບ້ານ ຫ້ວຍຂີ້ລີງ	ບ້ານ ລວງກວ້າງ	ບ້ານ ແກ້ງແລດ	ບ້ານ ຜາແວນ			
ບ້ານ ປ່າກາ	 	 	 			
ລະຫັດໄປສະນີ ເຂດ 3: 09032			
ບ້ານ ຜາແອ່ນ	ບ້ານ ຜາອໍ້	ບ້ານ ບວງດາວ	ບ້ານ ຄອກໝູ			
ບ້ານ ພູໜອງ	ບ້ານ ຜາງ້ອນ	 	 			
ລະຫັດໄປສະນີ ເຂດ 4: 09033			
ບ້ານ ຜາຫຼວງ	ບ້ານ ຄັງພະນຽນ	ບ້ານ ຖ້ຳເສືອ	ບ້ານ ໜອງສາມແຈ			
ບ້ານ ຜາຫວາຍ	ບ້ານ ປ່າຂົມ	ບ້ານ ຍອດຫວາຍ	ບ້ານ ໜອງແຫຼ້			
ບ້ານ ອ່າງຍອດຄາ			 			
ລະຫັດໄປສະນີ ເຂດ 3: 09034			
ບ້ານ ພັກແຄະໃຕ້	ບ້ານ ກໍທອງ	ບ້ານ ຫ້ວຍຊວງ	ບ້ານ ຍອດຄໍ			
ບ້ານ ພັກແຄະເໜືອ	ບ້ານ ໜອງກົບ	ບ້ານ ນ້ຳກົ້ນງົວ	ບ້ານ ນ້ຳເໝັນ			
ບ້ານ ຜາເມົາ			 			
ລະຫັດໄປສະນີ ເຂດ 4: 09035			
ບ້ານ ແກ່ວປະຕູ	ບ້ານ ທຸ້ມ	ບ້ານ ໜອງອໍ້	ບ້ານ ສັນໂດນ ກ			
ບ້ານ ຖ້ຳຄຸ	ບ້ານ ປ່າຫົກ	ບ້ານ ຜາລິນ	ບ້ານ ສັນໂດນ ຂ			
ລະຫັດໄປສະນີ ເຂດ 5: 09036			
ບ້ານ ພຽງມອນ	ບ້ານ ສົມໄຜ່	ບ້ານ ສັນຍົມ	ບ້ານ ຫ້ວຍລົມ			
ບ້ານ ສົບແຕນ	ບ້ານ ຖ້ຳປ່ອງ	ບ້ານ ບວກເສີ	ບ້ານ ປ່າແປກ			
ບ້ານ ກໍດູ່			 			
ລະຫັດໄປສະນີ ເຂດ 6: 09037			
ບ້ານ ໂພນໄຊ	ບ້ານ ນ້ຳຍວກ, ນ້ຳປິ	ບ້ານ ໜອງຂຽວ	ບ້ານ ສັນຍົມ			
ບ້ານ ຈຳໝື່ນ	ບ້ານ ປ່າລັນ	ບ້ານ ຫ້ວຍຄ້າງ	ບ້ານ ສາມແຈ			
ບ້ານ ປຸ່ງແຊງ	ບ້ານ ກະບໍ້	ບ້ານ ຫ້ວຍເທົ່າ	 			
ລະຫັດໄປສະນີ ເຂດ 7: 09038			
ບ້ານ ກໍມອນ	ບ້ານ ກ່ຽວກ້ອງ	ບ້ານ ຫ້ວຍຄ້ອງ	ບ້ານ ຜາເພີ			
ບ້ານ ກໍຫາດ	ບ້ານ ຖ້ຳຫີນ	ບ້ານ ຜາບອງ	ບ້ານ ນ້ຳຮອຍ			
ບ້ານ ຍອດຊາວ	ບ້ານ ພູຫົວຊ້າງ	ບ້ານ ວັນຄຳ	 			
ລະຫັດໄປສະນີ ເຂດ 8: 09039			
ບ້ານ ແກ່ວບອນ	ບ້ານ ຫາບໍ	ບ້ານ ຫ້ວຍແລນ	ບ້ານ ສອງຮອງ			
ບ້ານ ຫ້ອຍລົມ	ບ້ານ ຫ້ວຍນາ		 			
ລະຫັດໄປສະນີ ເຂດ 9: 09100			
ບ້ານ ຫ້ວຍດ່ານ	ບ້ານ ປ່າເລົ່າ	ບ້ານ ຍອດຕື້ນ	ບ້ານ ນ້ຳກູດໃໝ່			
ບ້ານ ດົງກໍ	ບ້ານ ປຸງ	ບ້ານ ໂພ	ບ້ານ ວຽງ			
ບ້ານ ຕີນຜາ	ບ້ານ ບວມຝາດ		 			
ລະຫັດໄປສະນີ ເຂດ 10: 09101			
ບ້ານ ກໍສ້ານ	ບ້ານ ພຽງຊືນ	ບ້ານ ຫ້ວຍກໍ້	ບ້ານ ປ່າຈ້າ			
ບ້ານ ພຽງຫົງ	ບ້ານ ຊ້າງເກັບ	ບ້ານ ສວນອ້ອຍ	ບ້ານ ສັນຍົມ			
ບ້ານ ແກ່ວເຈ້ຍ	ບ້ານ ປ່າໝີ	ບ້ານ ເຍຍ	ບ້ານ ໜອງ			
ເມືອງ ຜາໄຊ ລະຫັດໄປສະນີ 09040 - 09043   			
ລະຫັດໄປສະນີ ເຂດ 1: 09040 			
ບ້ານ ນາເພຍ ນາແຖງ	ບ້ານ ໄຮ	ບ້ານ ນາຮຸງ-ໜອງຫອຍ	ບ້ານ ລາດຄາຍ ນາມຸນ			
ບ້ານ ທາງຊຽງເໜືອ	ບ້ານ ໂພນ	ບ້ານ ຫໍໄຊ	ບ້ານ ນ້ຳກະ			
ບ້ານ ຊົວ	ບ້ານ ຊຽງດີ	ບ້ານ ຫວ້ານ	 			
ລະຫັດໄປສະນີ ເຂດ 2: 09041			
ບ້ານ ເຕົາ	ບ້ານ ລາດແສນ	ບ້ານ ຫໍກາງ	ບ້ານ ໂພສີ			
ບ້ານ ນາໂຄ້	ບ້ານ ງົ້ວ	ບ້ານ ນາສົມ	 			
ລະຫັດໄປສະນີ ເຂດ 3: 09042			
ບ້ານ ນາຂື່	ບ້ານ ສ່ອມ	ບ້ານ ໜອງ	ບ້ານ ພາເໜືອ			
ບ້ານ ທຸ່ມນາຕຽງ	ບ້ານ ຫໍສິມ	ບ້ານ ພາໄຕ້	ບ້ານ ປຸ່ງ			
ລະຫັດໄປສະນີ ເຂດ 4: 09043			
ບ້ານ ນ້ຳສຽມ	ບ້ານ ນາປັນ	ບ້ານ ຈ້ານ້ຳ	ບ້ານ ນາໄຊ			
ບ້ານ ຖ້ຳຕຳລຶງ	 	 	 			
ເມືອງ ໝອກ ລະຫັດໄປສະນີ 09050			
ບ້ານ ນາຄ່ອນ	ບ້ານ ນ້ຳເຢັນ	ບ້ານ ຊຳທອງ	ບ້ານ ໝໍ້			
ບ້ານ ນ້ຳຈັດ	ບ້ານ ຄັງວຽງ	ບ້ານ ນາແຄ	ບ້ານ ນ້ຳກ່ຽວ			
ບ້ານ ຜາແດງ	ບ້ານ ນາເມືອງ	ບ້ານ ນ້ຳທ່ຽງ	ບ້ານ ຢວກ- ມູນ			
ບ້ານ ນ້ຳເກັ່ງ	ບ້ານ ທົ່ງເປີ້	ບ້ານ ນ້ຳຈາວເໜືອ	ບ້ານ ສາມແຈ			
ບ້ານ ນ້ຳຢ້ຽມ	ບ້ານ ນ້ຳຕາກ	ບ້ານ ຊຽງເໝັ້ນ	ບ້ານ ປ່າຄາ			
ບ້ານ ນ້ຳຕືນ	ບ້ານ ຈະເລີນໃໝ່	ບ້ານ ນາມອນ	ບ້ານ ພູມອນ			
ບ້ານ ຖ້ຳສ່ວຍ	ບ້ານ ນ້ຳຫງາດ	ບ້ານ ນ້ຳຈາວໃຕ້	ບ້ານ ຊອງ			
ເມືອງ ພູກູດລະຫັດໄປສະນີ 09060 			
ບ້ານ ລ້ອງຄາວ	ບ້ານ ມຽນ	ບ້ານ ສຸຍໜອງຕັ່ງ	ບ້ານ ດຸກ			
ບ້ານ ລ້ອງຄານ	ບ້ານ ປຸ່ງໝັ້ນ	ບ້ານ ປັ້ງປາງ	ບ້ານ ມາງ			
ບ້ານ ມ່ວງຄຳ	ບ້ານ ຮະງວມ	ບ້ານ ນ້ຳຈັດ	ບ້ານ ຈອມສີ			
ບ້ານ ຍອດແພ	ບ້ານ ນາຊາຍທອງ	ບ້ານ ນ້ຳສາມ	ບ້ານ ນາຂ່າ			
ບ້ານ ແລທອງ	ບ້ານ ພູວຽງ	ບ້ານ ຊຽງແດດ	ບ້ານ ພູແຊວ			
ບ້ານ ຢາຍ	ບ້ານ ຊາຍ	ບ້ານ ແປນ	ບ້ານ ຊຽງງາ			
ບ້ານ ໂຈຍ	ບ້ານ ອ່າງ	ບ້ານ ເຄິງ	ບ້ານ ສົມບູນ			
ບ້ານ ມີໄຊ	ບ້ານ ຊອງ	ບ້ານ ຫວດຕັນ	ບ້ານ ໄຊອຸດົມ			
ບ້ານ ບົງ	ບ້ານ ໜອງກາງ	ບ້ານ ພຽງຫຼວງ	ບ້ານ ພຽງດີ			
ບ້ານ ວັງໂຕ່ງ	ບ້ານ ສັກສອດ	ບ້ານ ລັ້ງຈອງ	ບ້ານ ສົບຄາວ			
ບ້ານ ລ້ອງຮາງ	ບ້ານ ນາຄວນ	ບ້ານ ປົວ	 			

ແຂວງ ວຽງຈັນ
ເລກລະຫັດໄປສະນີ 10000
ແຂວງ ວຽງຈັນ 10xxx				
ເມືອງ ໂພນໂຮງ ເລກລະຫັດໄປະນີ 10000 - 10004  				
ລະຫັດໄປສະນີ ເຂດ 1: 10000				
ບ້ານ ໂພນສີໃຕ້	ບ້ານ ໂພນໂຮງ	ບ້ານ ໜອງບົວ	ບ້ານ ໂພນໄຊ				
ບ້ານ ນໍ້າລິນ	ບ້ານ ຫ້ວຍປຸ່ງ	ບ້ານ ໂພນຂາມ	 				
ລະຫັດໄປສະນີ ເຂດ 2: 10001         				
ບ້ານ ນໍ້າແຈ້ງ	ບ້ານ ຫ້ວຍທົນ	ບ້ານ ໂພນສົມບູນ	ບ້ານ ໂພນເງິນ				
ບ້ານ ໂພນສະຫວ່າງ	ບ້ານ ໂພນຕ້ອງ	ບ້ານ ນາແພງ	ບ້ານ ນ້ອຍນາໂພ				
ບ້ານ ນາຊາຍ	 	 	 				
ລະຫັດໄປສະນີ ເຂດ 3: 10002         				
ບ້ານ ນາໂພເໜືອ	ບ້ານ ນໍ້າຈີມ	ບ້ານ ໂພນຫໍ	ບ້ານ ເພຍ				
ບ້ານ ໜອງເຕົ່າ	ບ້ານ ນາກໍ່າ	ບ້ານ ແສນສະອາດ	 				
Phonsynuea	Saenxoum	Namuang	 				
ລະຫັດໄປສະນີ ເຂດ 4: 10003         				
Nalao	Nazu+Sybounhueang	Naxuak	Nalao				
Phonhai	Sangyai	Phonsyda	 				
Phon	Nathong	Nayang	 				
Phontha	Nalorngkhoun	Phonsaward	 				
ລະຫັດໄປສະນີ ເຂດ 5: 10004         				
Phonkeo	Kharm	Yuad	 				
Thard-Hardtha	Naphophalard	Vungmon	 				
ເມືອງ ທຸລະຄົມ ລະຫັດໄປສະນີ 10010 - 10014 				
ລະຫັດໄປສະນີ ເຂດ 1: 10010         				
Kernnuea	Kerntai	Namark	 				
Kernkang	Phonhae	Nalung	 				
ລະຫັດໄປສະນີ ເຂດ 2: 10011         				
Bor	Phoukaonang	Phonngam-Nafaiy 	Phonhong				
Nabor	Namarng	Phathaow	Parkhang				
Naphei		 	 				
ລະຫັດໄປສະນີ ເຂດ 3: 10012         				
Naphaeng	Namyarm	Phoukhaokhuay	Nangern				
Nawar	Vunghuea	Nayang	Nanokkhoum				
ລະຫັດໄປສະນີ ເຂດ 4: 10013        				
Haiyorn	Nongphong	Tarnpiew	Chaeng				
Dong	Hardsuan	Choum	Nonghai				
ລະຫັດໄປສະນີ ເຂດ 5: 10014        				
Nakhong	Hardxay	Lingzun	Hardsiew				
Phonkham	Boungphao	Phonphaeng	Nakeo				
ເມືອງ ແກ້ວອຸດົມ ລະຫັດໄປສະນີ 10020 - 10026  				
ລະຫັດໄປສະນີ ເຂດ 1: 10020         				
Thinkeo	Thalard	Napoun	 				
ລະຫັດໄປສະນີ ເຂດ 2: 10021         				
Phonyaeng	Lorngkhan	Phonmuang	 				
ລະຫັດໄປສະນີ ເຂດ 3: 10022         				
Phukhaokham	Keoku	Phonkham	Kharmxang				
ລະຫັດໄປສະນີ ເຂດ 4: 10023         				
Kokkieng	Hardtha	Khonekoum	Naxaeh				
Viengkham	Kaenghai	Nayaow	 				
ລະຫັດໄປສະນີ ເຂດ 5: 10024         				
Samukkhexay	Hardxaiyngarm	Phonsavath	Hardduea				
ລະຫັດໄປສະນີ ເຂດ 6: 10025         				
Saengsawang	Huaypoung	Sokepakeo	 				
Maiphonyaeng	Donexayaoudom	 	 				
ລະຫັດໄປສະນີ ເຂດ 7: 10026         				
Huaykhong	Dansavath	 	 				
ເມືອງ ວັງວຽງ ລະຫັດໄປສະນີ 10030 - 10036  				
ລະຫັດໄປສະນີ ເຂດ 1: 10030         				
Vungvieng	Naduang	Huaysangao	Viengkeo				
Viengsamai	Nakhae	Phonphaeng	Mueangxong				
Parkpoc	Phoudindaeng	Sawang	Huayae				
ລະຫັດໄປສະນີ ເຂດ 2: 10031       				
Phonxou	
Viengxay	Vungxorng	Nakhoun				
Huayngam	Khunmark	Phonsoung	 				
ລະຫັດໄປສະນີ ເຂດ 3: 10032        				
Vungmieng	Phonsawang	Nakhom	Ngiwtai				
Phonvieng	Phonkeo	Keokhoun	 				
Namone	Phonyang	Vunghuea	 				
Namonenuea	Nalao	Namngard	 				
ລະຫັດໄປສະນີ ເຂດ 4: 10033         				
Somsaward	Naphadaeng	Nadao	Phathao				
Phahorm	Phatung	Sokexay	Phoxay				
ລະຫັດໄປສະນີ ເຂດ 5: 10034         				
Huaymor	Thahueatai	Namphaow	Nampardtai				
Thahueanuea	Huaypamorm	Huayzy	 				
ລະຫັດໄປສະນີ ເຂດ 6: 10035        				
Nampae	Nalongkuang	Nathong	Phonngern				
Naxay	Namuang	Nazom	 				
Phonxay	Phathong	Phonkham	 				
ລະຫັດໄປສະນີ ເຂດ 7: 10036         				
Huaynamyen	Keokuang	Thinaorn	Nakhuang				
Nayae	Vungphai	Zuang	 				
ເມືອງ ເຟືອງ ລະຫັດໄປສະນີ 10040 - 10044  				
ລະຫັດໄປສະນີ ເຂດ 1: 10040         				
Nakang	Nathong	Thar	Nathuar				
Laokham	Phonxay	Done	 				
ລະຫັດໄປສະນີ ເຂດ 2: 10041         				
Phonxay	Phonthone	Phonyaeng+Namon	Nathoun				
Naphueng	Nakhaeng	Namhai	Phouphieng				
ລະຫັດໄປສະນີ ເຂດ 3: 10042         				
Nampoung	Nawarn	Phonsaward	Mueangfueang				
Nongpor	Phosy	Khonelueang	Sarmmuen				
ລະຫັດໄປສະນີ ເຂດ 4: 10043         				
Nabone	Nongpet	Namai	Parknguar				
Naxaeng	Kaengxieng	Sysa-ard	Na-aun				
Natiw	 	 	 				
ລະຫັດໄປສະນີ ເຂດ 5: 10044         				
Nalung	Na-arng	Nakhorp	Namueang				
Phonsawang	Phaluang	Phasung	Saenxay				
Huayduea	Nakham	Parkhung	Nonhinhaer				
ເມືອງ ຊະນະຄາມ ລະຫັດໄປສະນີ 10050 - 10057 				
ລະຫັດໄປສະນີ ເຂດ 1: 10050         				
Sanakharm	Syphoum	Tarkdaed	Parkmee				
ລະຫັດໄປສະນີ ເຂດ 2: 10051         				
Parkphang	Phalard	Chuansavanth	 				
ລະຫັດໄປສະນີ ເຂດ 3: 10052         				
Pong	Naphieng	Nafa	Namork				
ລະຫັດໄປສະນີ ເຂດ 4: 10053         				
Buasavath	Dongkhar	Nonsavath	Nasak				
Nonchalern		 	 				
ລະຫັດໄປສະນີ ເຂດ 5: 10054        				
Phonsawang	Huaytaow	Namkuan	Nakhoun				
Nadou	 	 	 				
ລະຫັດໄປສະນີ ເຂດ 6: 10055         				
Namoiy	Nonhuaxang	Nakang	Saenchalern				
ລະຫັດໄປສະນີ ເຂດ 7: 10056         				
Nasomboun	Huaykua	Nasawang	Namzou				
ລະຫັດໄປສະນີ ເຂດ 8: 10057        				
Khokkhaodor	Parkthoun	Donephoung	Huaykhayaeng				
Khokngiw	Donesoke	Huaytao	 				
ເມືອງ ກາສີ ລະຫັດໄປສະນີ 10060 - 10065 				
ລະຫັດໄປສະນີ ເຂດ 1: 10060         				
Viengkeo	Phooukham	Nathaen	 				
ລະຫັດໄປສະນີ ເຂດ 2: 10061        				
Nazou	Phonsyda	Namkaen	Hinngon				
Phonngam	Huamueang	Kiwkuang	Lorngmarkkhaiy				
Keoxomphou	Phachao	Nampaep	 				
ລະຫັດໄປສະນີ ເຂດ 3: 10062        				
Namon	Nongbuathong	Phonsaward	Thongmuead				
Viengsamai		 	 				
ລະຫັດໄປສະນີ ເຂດ 4: 10063        				
Phonbaeng	Phokham	Sysungvone	Sala				
Chieng	Phonthieng	Namone	Phalek				
ລະຫັດໄປສະນີ ເຂດ 5: 10064        				
Phaxang	Nongkham	Daendin	Phouhinlekfai				
Buanphoun	Huayhok	 	 				
ລະຫັດໄປສະນີ ເຂດ 6: 10065        				
Huaynamfod	Naxungthong	Namphueng	 				
ເຂດ ຫລັກ 52 ລະຫັດໄປສະນີ 10070 - 10074  				
ລະຫັດໄປສະນີ ເຂດ 1: 10070          				
Luk 52	Phonkhamnuea	Phonkhamtai	Nalao				
ລະຫັດໄປສະນີ ເຂດ 2: 10071          				
Nongnakyai	Nongnaknoy	Phusun	Phonngarm				
ລະຫັດໄປສະນີ ເຂດ 3: 10072          				
Honglueay	Huayduea	Sakar	Phonyang				
Nongkhone	Vungmon		 				
ລະຫັດປສະນີ ເຂດ 4: 10073				
Aekxang	Nongpoung	Phonkhorng	Chaengsawang	 			
Phonthan	 	 	 				
ລະຫັດໄປສະນີ ເຂດ 5: 10074				
Taotharn	Nathep	Mai	Sivilay				
Phonxay	Phonsoung	Dongkhaow	 				
ເມືອງ ວຽງຄໍາ ລະຫັດໄປສະນີ 10080 - 10083  				
ລະຫັດໄປສະນີ ເຂດ 1: 10080          				
Phonxong	Phonmeenuea	Phonmeetai	 				
ລະຫັດໄປສະນີ ເຂດ 2: 10081          				
Nonsawang			 				
ລະຫັດໄປສະນີ ເຂດ 3: 10082          				
Nanin	Napakhaow	Nakhuea	Vernsarn				
ລະຫັດໄປສະນີ ເຂດ 4: 10083          				
Mueangkao	Donekuad	Viengkham	Phonhung				
Thaphoxay	Thinyoung	Nongkhuay	Maiphosy				
Parkchaeng			 				
ເມືອງ ໝື່ນ ລະຫັດໄປສະນີ 10090 - 10095  				
ລະຫັດໄປສະນີ ເຂດ 1: 10090          				
Nonhai	Phonngam	Namhorn	Napaphai				
Sivilay	 	 	 				
ລະຫັດໄປສະນີ ເຂດ 2: 10091          				
Namphern	Nayaow	Nontorng	Nabua				
ລະຫັດໄປສະນີ ເຂດ 3: 10092          				
Natard	Namor	Phonsaen	Namphaed				
Namlao	Mueangmuen 	 	 				
ລະຫັດໄປສະນີ ເຂດ 4: 10093         				
Parkhang	Phasungnuea	Phonsawang	Saenxay				
Phasungtai	Nakham-Mueangfueang	 	 				
ລະຫັດໄປສະນີ ເຂດ 5: 10094          				
Namhee	Konekham	Khokmuead	Parkchan				
ລະຫັດໄປສະນີ ເຂດ 6: 10095         				
Vung	Donehieng	Parkxaow	 				
ເມືອງ ແມດ ລະຫັດໄປສະນີ 10100 - 10104  				
ລະຫັດໄປສະນີ ເຂດ 1: 10100          				
Nadorkkhoun	Huayxom	Nakangpa	Namyone				
Nangiw	Nathao		 				
ລະຫັດໄປສະນີ ເຂດ 2: 10101          				
Namfueang	Mueangmaed	Pamark	Napajard				
Namhuang	Napho	Hardyaow	 				
ລະຫັດໄປສະນີ ເຂດ 3: 10102        				
Naparn	Nayaow	Sysavard	Nampou				
Sysa-ardnuea	Nady	Pakyun	 				
ລະຫັດໄປສະນີ ເຂດ 4: 10103          				
Nonsaward	Parkphaen	Samukkhexay	Namon				
Sysa-ardtai	Namphaen	Namharn	 				
ລະຫັດໄປສະນີ ເຂດ 5: 10104          				
Mueangkhee	Huaykuar	Na-aoudomtai	Donexaiymgam				
Nasawang	Phonyaeng		 				
ເມືອງ ຫີນເຫີບ ລະຫັດໄປສະນີ 10110 - 10114  				
ລະຫັດໄປສະນີ ເຂດ 1: 10110          				
Hinherp nuea	Hinngonh	Hinlup	Khonekang				
Hinherp tai	Phonsavanth	Phonsoung	 				
Viengthong	Huay-elerd	Khonekeo	 				
ລະຫັດໄປສະນີ ເຂດ 2: 10111          				
Khonephouk	Phonsawang	Nakham	Nakhoum				
Phonmuang	Nathong	Tungkham	Naxat				
Borcharn			 				
ລະຫັດໄປສະນີ ເຂດ 3: 10112          	 			
Naphorng	Nataiy	Phaborng	Nakang				
Nalueang	Na-aun	Norngluang	 				
ລະຫັດໄປສະນີ ເຂດ 4: 10113          				
Hintid	Somsanouk	Nampat	Vungkhee				
Sivilay	Pongxorng	Huaydorkmai	Viengthongnuea				
ລະຫັດໄປສະນີ ເຂດ 5: 10114         				
Khonekaen	Phonthongtai	Naphong	Namthonh				
Phonngern	Viengkham	Nawaii	Suanmone				
Phongkham	Mouk	 	 				








ແຂວງ ບໍລິຄຳໄຊ
ເລກລະຫັດໄປສະນີ 11000
ແຂວງບໍລິຄຳໄຊ 11xxx								
ເມືອງ ປາກຊັນ ລະຫັດໄປສະນີ  11000 - 11001 								
ລະຫັດໄປສະນີ ເຂດ 1: 11000								
Meexay	Sivilay	Thasykhai	Phonsa-ard	 							
Sysa-ard	Namngiep	Phonxay	Huaysied	 							
Kuayaoudom	Symoungkhoun		 	 							
ລະຫັດໄປສະນີ ເຂດ 2: 11001	 							
Phoxay	Anousonexay	Patxoum	Suansavanth	 							
Nachik	Thong	Parkxuntai	Sanaxay	 							
ເມືອງ ບໍລິຄັນ ລະຫັດໄປສະນີ  11010 - 11011  								
ລະຫັດໄປສະນີ ເຂດ 1: 11010								
Vatthard	Nahaen	Sysaward	Nonsomboun	 							
Haddorkkhoun	Phonkharm	Na-O	Phonmoungkhoun	 							
ລະຫັດໄປສະນີ ເຂດ 2: 11011	 							
Nalorng	Huana	Phonsaward	Dong	 							
Khaenyorng			 	 							
ເມືອງ ປາກກະດິງ ລະຫັດໄປສະນີ 11020 	 							
Parkkading	Saensamlarn	Borthuen	Hardxaiykhoun								
Parksa	Nabone	Donexy	Phoxay								
Phonsy	Phonkham	Somsanouk	Nayang								
Phonngam	Parkzoun	Xord	Nakuang								
ເມືອງ ທ່າພະບາດ ລະຫັດໄປສະນີ  11030   								
Thabok	Parlai	Phapong	Aoudomxay								
Huaylerk	Hongthong	Thuayyai	Thuaymai								
Phabard	Namkham	Somsa-ard	 								
ເມືອງ ຄຳເກີດ ລະຫັດໄປສະນີ  11040  								
Luk 20	Nongporng	Namphaow	Phonphaeng								
Huaykeo 1	Somsanouk	Phonhong	Nongdong								
thongchalern	Phonmueangnoy	Aoudom	 								
ເມືອງ ວຽງທອງ ລະຫັດໄປສະນີ 11050  								
Namyang	ບ້ານ ວັງຫີນ	ບ້ານ ສົບນາ	ບ້ານ ທ່າແພ								
ເຂດ ທົ່ງນາມີລະຫັດໄປສະນີ 11060  								
Namduea	Namkhu	Nabone	Namsang	 							
Viengkham	 	 	 	 							
ເມືອງ ຈອມພອນ ບໍ່ມີໄປສະນີ								









ແຂວງ ຄຳມ່ວນ
ເລກລະຫັດໄປສະນີ 12000
ແຂວງ ຄຳມ່ວນ 12xxx				
ເມືອງ ທ່າແຂກ ລະຫັດໄປສະນີ 12000 - 12005 				
ລະຫັດໄປສະນີ ເຂດ 1: 12000				
Chormthong	Donekhueanxang	Laophongam	Sangome				
Santisouk	khamarng	Nakaikhia	Phonsavanth				
Nabong	Nongmieng	Natard	Vern				
Chomchaeng	Phonsa-ard	Nanongkeo	Kokhai				
Laophoxay	Phonsanarm	Maiphosy	Yayarwaii				
ລະຫັດໄປສະນີ ເຂດ 2: 12001				
Naniyom	Donenarai	Muang	Nasatho				
Phonduea	Muangsoum	Phondou	Nadon				
Yangngam	Kuanphavung	Songkhone	Yangbueng				
Thaduea	Nayor	Phalaem	Namalard				
Sykhode	Muangdoy	Nangeo	Phonyiayai				
ລະຫັດໄປສະນີ ເຂດ 3: 12002				
Maitardthong	Somsa-ard	Phonphim	Kommaked				
Khamboun	Chomngern	Donemuang	Nakang				
Nabor	Phonsavanth	Sivilay	Nontoum				
Nongbuakham	Parksymung	Thangam	Dongtai				
Nongbuangern	Phonsaoaey	Nahae	Donthong				
Khambone	Pakdong	Nadinchee	 				
ລະຫັດໄປສະນີ ເຂດ 4: 12003				
Naphotha	Laongua	Phon	Nasa-ard				
Khokeparthone	Xiengwaen	Phonyianoy	Xienglae				
Nonghang	Thacare	Koungsy	Mueangbar				
Parkpeng	Phin	Yangkao	Dongkasaen				
Doneyai	Phonsawang	Khokehet	Nabo				
Bunghieng	Thork	Somboun	Huaynanglee				
ລະຫັດໄປສະນີ ເຂດ 5: 12004				
Chomphet	Chomkeo	Koktong	Hardkham				
Thakhaekkang	Namdon	Dongxork	Phonsawang				
Huaynagsord	Phonsoung	Phoxay	Nangou				
Namueang	Donedon	Namuang	Nataked				
Thakhaeknuea	Kaengyang	Phonkhoun	Phuknarm				
ລະຫັດໄປສະນີ ເຂດ 6: 12005				
Nangeo	Na	Muanglardkhuay	Nongphunna				
Nakork	Nakhangxang	Khokesaohuean	Nakoum				
Tarn	Huana	Sysomlat	Yangkome				
Kaboud	Thum	Khokexang	 				
Dongmuangkhai	Nasey	Kangba	 				
Phontong	Khamkheekai	Khamdorkmai	 				
ເມືອງ ມະຫາໄຊບໍ່ມີຫ້ອງການ ລະຫັດໄປສະນີ 12010 - 12013				
ລະຫັດໄປສະນີ ເຂດ 1: 12010				
Luk 7	Nady	Chaloum	Khamphaeyai				
Nakork	Nadou	Kokkhaen	Kaengsawang				
Phovanuea	Lao	Phakiw	Nalee				
Nasaer	Nakatharng	Nacare	Vern				
Nakham	Namarkbar	Nammala	Elarn				
ລະຫັດໄປສະນີ ເຂດ 2: 12011				
Nakiew	Sarngphork	Mahaxaynuea	Phonsa-ard				
Phonmueang	Haitai	Phovatai	Phonsavath				
Hainuea	Phonnady	Pakxorng	Parnarm				
Kawark	Taengdong	Natoung	Nakatharngdong				
Phonsavath	Luk 9	Kuankhuay	Kavah				
ລະຫັດໄປສະນີ ເຂດ 3: 12012				
Maiphosy	Pong	Naphakeo	Phachoumkhorng				
Kuanluang	Natharndong	Naxaow	Mahaxaykang				
Nathone	Nakhaiy	Phonyang	Nongkork				
Phondaeng	Darnkang	Xork	Mahaxaytai				
Donedong	Somsanouk	Khamphahaeng	Kaengyangkham				
Khampheydong	Man	Naphuak	Taen				
ລະຫັດໄປສະນີ ເຂດ 4: 12013				
ບ້ານໂພນໄຫຼ	ບ້ານ ຜາແຄນ	ບ້ານ ນາທ່ານທົ່ງ	ບ້ານ ໂພນເຫຼັກ				
ບ້ານ ໂພນຄຳ	ບ້ານ ໂພນສະໜືນ	ບ້ານ ນາຟອງ	ບ້ານ ໂພນໄຊ				
ບ້ານ ຜານາງ	ບ້ານ ນາງີ້ວ	ບ້ານ ວັດທາດ	ບ້ານ ກວນຕັນ				
ບ້ານ ນາສະຖູງ	ບ້ານ ຄຳແພນາ	ບ້ານ ທົ່ງກວາງ	ບ້ານ ແຕງທົ່ງ				
ບ້ານ ນາກະທ້າງນ້ອຍ	ບ້ານ ນາສະຫວ່າງ	ບ້ານ ໂພນແດງ	ບ້ານ ນາຕາພອນ				
ບ້ານ ນາຈານ	ບ້ານ ຄຳເຟືອງ	ບ້ານ ວັງປູນ	 				
ເມືອງ ໜອງບົກ ລະຫັດໄປສະນີ 12020 - 12024 				
ລະຫັດໄປສະນີ ເຂດ 1: 12020				
ບ້ານ ໜອງບົກ	ບ້ານ ຊຽງຫວາງຫວຽດ	ບ້ານ ນາຈຳປາ	ບ້ານ ດົງບູນນ້ອຍ				
ບ້ານ ໜອງສະພັງບົກ	ບ້ານ ໂພນຕິ້ວ	ບ້ານ ດົງຄຸງ	ບ້ານ ບຶງສານເທີງ				
ບ້ານ ດົງຂວາງ	ບ້ານ ສອງເໝືອງເໝືອ	ບ້ານ ດົງແຕ້	ບ້ານ ດອນຂຽວເໝືອ				
ບ້ານ ດົງຍາງ	ບ້ານ ປົ່ງກີ່ວ	ບ້ານ ໂນນຈິກ	ບ້ານ ດອນຂຽວໃຕ້				
ລະຫັດໄປສະນີ ເຂດ 2: 12021				
ບ້ານ ໝອງຫຼົ່ມ	ບ້ານ ຕານເທີງ	ບ້ານ ສີບຸນເຮືອງ	ບ້ານ ຊຽງຫວາງທ່າ				
ບ້ານ ດອນໝາກໂມ	ບ້ານ ໝອງສະພັງທົ່ງ	ບ້ານ ໂພນ	ບ້ານ ກຸດຈັບ				
ບ້ານ ສອກເບາະ	ບ້ານ ນາວາງໄຕ້	ບ້ານ ນາມັນປາ	ບ້ານ ໂນນສີລາ				
ບ້ານ ຫາດຊຽງດີ	ບ້ານ ນາວາງນ້ອຍ	ບ້ານ ໝອງປະຫຼາດ	ບ້ານ ເຫຼົ້ານາ				
ລະຫັດໄປສະນີ ເຂດ 3: 12022				
ບ້ານ ໝອງຜຳ	ບ້ານ ບຶງສານທ່າ	ບ້ານ ດົງພັງເພົາ	ບ້ານ ນາວາງເໜືອ				
ບ້ານ ດົງກະສິນ	ບ້ານ ດອນສະຫວ່າງ	ບ້ານ ນາໄຕ້	ບ້ານ ນາວາງໃຕ້				
ບ້ານ ນາຄຳ	ບ້ານ ດອນປາແດກ	ບ້ານ ດົງສະຫງຳ	ບ້ານ ສະດຶໄຕ້				
ບ້ານ ນານ້ອຍ	ບ້ານ ປາກເດີດ	ບ້ານ ໝອງລີ	ບ້ານ ສະດຶເໜືອ				
ລະຫັດໄປສະນີ ເຂດ 4: 12023				
ບ້ານ ໝອງໂດນ	ບ້ານ ຊຽງຫວາງທົ່ງ	ບ້ານ ນາເຫຼັກ	ບ້ານ ນ້ຳຜຸ				
ບ້ານ ສັນຕິສຸກ	ບ້ານ ສອງເໝືອງໃຕ້	ບ້ານ ໂພໄຊ	ບ້ານ ດົງບູນໃຫຍ່				
ບ້ານ ໝອງສະພັງມ່ວງ	ບ້ານ ນາຫູນ	ບ້ານ ໂພນແພງ	ບ້ານ ສົມສະນຸກ				
ລະຫັດໄປສະນີ ເຂດ 5: 12024				
ບ້ານ ດອນຂຽວກາງ	ບ້ານ ດ່ານປາກເຊ	ບ້ານ ດົງຜັກເຜື້ອ	ບ້ານ ທ່າມ່ວງ				
ບ້ານ ມ່ວງໄຂ່	ບ້ານ ຜັກອີ່ຕູ່	ບ້ານ ຊຳນາດີ	ບ້ານ ໂພນສາວເອ້				
ບ້ານ ໂຄກກ່ອງ	ບ້ານ ຫາດຊາຍຟອງ	ບ້ານ ໂຄກສະຫວ່າງ	 				
ເມືອງ ຫີນບູນ ລະຫັດໄປສະນີ  12030 - 12035				
ລະຫັດໄປສະນີ ເຂດ 1: 12030				
ບ້ານສາມັກຄີໄຊ	ບ້ານ ໂພນສະຫວ່າງ	ບ້ານ ນ້ຳດິກ	ບ້ານ ນາຂໍ				
ບ້ານ ສອງຫ້ອງ	ບ້ານ ໂພນເໝັ້ນ	ບ້ານ ນາທານ	ບ້ານ ຕ້ອນນ້ອຍ				
ບ້ານ ວັງຫົວປາ	ບ້ານ ໜອງຂຸ່ນ	ບ້ານ ໂພນແພງ	ບ້ານ ຫາດແຮ່				
ບ້ານ ໂພນມ່ວງ	ບ້ານ ບົງ	ບ້ານ ນາຄື	ບ້ານ ຫີນບູນໄຕ້				
ລະຫັດໄປສະນີ ເຂດ 2: 12031				
ບ້ານ ໂພກຄ້ຳ+ຈຸດສອງ	ບ້ານ ດອນລັບ	ບ້ານ ຫ້ວຍບອນ	ບ້ານ ນາສາ				
ບ້ານ ໂພນດີ	ບ້ານ ຫ້ວຍຕີ້ວ	ບ້ານ ໜອງຫຼວງ	ບ້ານ ຜາແຫຼມ				
ບ້ານ ຫີນລາດ	ບ້ານ ຫ້ວຍກະວະເໜືອ	ບ້ານ ໂພນສູງ	ບ້ານ ມ່ວງໄຂ່ກາງ				
ບ້ານ ພົງກາງ	ບ້ານ ຫົວຫາດ	ບ້ານ ໂພໄຊ	ບ້ານ ນາ				
ບ້ານ ນາເໝືອ	ບ້ານ ດົງກາງ	ບ້ານ ບໍແໜ່ງ	ບ້ານ ນາອັ້ນ				
ລະຫັດໄປສະນີ ເຂດ 3: 12032				
ບ້ານ ຫົວນາ	ບ້ານ ນາເຮືອງ	ບ້ານ ທ່າໝີ	ບ້ານ ວັງຄ້ອງ				
ບ້ານ ຄຳແກ້ວ	ບ້ານ ໜອງບົວ	ບ້ານ ຄອນແກ້ວ	ບ້ານ ໂພນສະຫວັນ				
ບ້ານ ໝອງຫອຍ	ບ້ານ ໜອງຈັນ	ບ້ານ ໂຮມພັມ	ບ້ານ ດອນດູ່				
ບ້ານ ຫ້ວຍສະກູນ	ບ້ານ ແສງອາລຸນ	ບ້ານ ໜອງຜື	ບ້ານ ສີວິໄລ				
ບ້ານ ຫີນບູນ	ບ້ານ ທ່າແຄນ	ບ້ານ ໃໝ່ນ້ຳປະກັນ	ບ້ານ ຫາດຊາຍຄຳ				
ລະຫັດໄປສະນີ ເຂດ 4: 12033				
ບ້ານ ພົງໄຕ້	ບ້ານ ຫາດໃຫຍ່	ບ້ານ ວຽງທອງ	ບ້ານ ມ່ວງໄຂ່ໄຕ້				
ບ້ານ ປຸ່ງເໜືອ	ບ້ານ ຫ້ວຍເຂົ້າໜີ້ນໃຫຍ່	ບ້ານ ຫ້ວຍອອນ	ບ້ານ ນາຮີ				
ບ້ານ ຫ້ວຍຂຽວ	ບ້ານ ນາກາແດ້ງ	ບ້ານ ວັງເຜີ້ງ	ບ້ານ ກວນກະຈາ				
ບ້ານ ທ່າສົມໂຮງ	ບ້ານ ດ່ານຮີ	ບ້ານ ທົ່ງຄຳ	ບ້ານ ສີສົມຊື່ນ				
ບ້ານ ຫ້ວຍກະວະໄຕ້	ບ້ານ ເຫຼົ້າຄຳ	ບ້ານ ນ້ອຍ	ບ້ານ ປາກປະກັນ				
ລະຫັດໄປສະນີ ເຂດ 5: 12034				
ບ້ານ ແກ້ງຜັກຄຳ	ບ້ານ ນາຫ່າງ	ບ້ານ ໂພນຂາມ	ບ້ານ ໂພນຄ້ຳ				
ບ້ານ ຫາດນານ້ອຍ	ບ້ານ ນາໂນ	ບ້ານ ຜາແດງ	ບ້ານ ປຸ່ງ				
ບ້ານ ຜາວັງ	ບ້ານ ນາໂພ	ບ້ານ ໄຊສົມບູນ	ບ້ານ ແມງ				
ບ້ານ ຫີນຄັນ	ບ້ານ ໝອງສະໂນ	ບ້ານ ໝອງບົວນ້ອຍ	ບ້ານ ພົງເໝືອ				
ລະຫັດໄປສະນີ ເຂດ 6: 12035				
ບ້ານ ໂພນຄຳ	ບ້ານ ນາບອນ	ບ້ານ ນາໂດນ	ບ້ານ ຊາວ				
ບ້ານ ປຸ່ງໄຕ້	ບ້ານ ຫ້ວຍເຂົ້າໜີ້ນນ້ອຍ	ບ້ານ ຫ້ວຍຊາຍ	ບ້ານ ໜອງຊືນ				
ບ້ານ ທ່າສະຫວ່າງ	ບ້ານ ຫ້ວຍເຮືອ	ບ້ານ ບູມລູ	 				
ບ້ານ ຫ້ວຍກະຊະ	ບ້ານ ໂພນສະອາດ	ບ້ານ ມ່ວງໄຂ່ເໜືອ	 				
ບ້ານ ໃໝ່ສີວິໄລ	ບ້ານ ກະແຕບ	ບ້ານ ທ່າຫຍໍ້	 				
ເມືອງ ຍົມມາລາດ ລະຫັດໄປສະນີ 12040 - 12043				
ລະຫັດໄປສະນີ ເຂດ 1: 12040				
ບ້ານ ສີບຸນເຮືອງ	ບ້ານ ໜອງປີງ	ບ້ານ ນາໄຮ່	ບ້ານ ຫົວຕາດ				
ບ້ານ ດອນສະຫວ່າງ	ບ້ານ ແກ້ງເຫຼັກ	ບ້ານ ນາກະຕັງ	ບ້ານ ວຽງຫຼວງ				
ບ້ານ ຍົມມະລາດໃຕ້	ບ້ານ ໂພນສະຫວັນ	ບ້ານ ພີດ	ບ້ານ ປ້ອມຄູນ				
ບ້ານ ຖໍ້າພວງ	ບ້ານ ນາໂພໄຊ	ບ້ານ ຜາທຸງ	ບ້ນ ຖ້ຳຄວາຍ				
ບ້ານ ທ່າໂທດໄຕ້	ບ້ານ ດອນເປືອຍ	ບ້ານ ກວນພັນ	ບ້ານ ໄຮ່				
ລະຫັດໄປສະນີ ເຂດ 2: 12041				
ບ້ານ ນາແດນ	ບ້ານ ຂີ້ເຫັລກ	ບ້ານ ວັດທາດ	ບ້ານ ໂພນບົກ				
ບ້ານ ໄຮ່ຜາວຽງ	ບ້ານ ນາທິນ	ບ້ານ ກໍບົງ	ບ້ານ ໂພນສະອາດ				
ບ້ານ ທ່າໂຈມ	ບ້ານ ສົມສະນຸກ	ບ້ານ ນາມີໄຊ	ບ້ານ ໜອງກະຈິງ				
ບ້ານ ບໍ່ສົມບູນ	ບ້ານ ຕະຫລາກ	ບ້ານ ກຸດຜາດ່າງ	ບ້ານ ນາໂພໄຊໄຕ້				
ບ້ານ ຄຳແຮ	ບ້ານ ຍົມມະລາດເໜືອ	ບ້ານ ໂພນລາດຄວາຍ	ບ້ານ ຫ້ວຍເຢັນ				
ລະຫັດໄປສະນີ ເຂດ 3: 12042				
ບ້ານ ໂພນຕູມ	ບ້ານ ກວນຫຼວງ	ບ້ານ ໜອງຂາວ	ບ້ານ ສົມສະອາດ				
ບ້ານ ໂພນສະຫວາງ	ບ້ານ ໂພນສີ	ບ້ານ ຈະກ້ວນ	ບ້ານ ແກ້ວວິໄລ				
ບ້ານ ໂພນແຄນ	ບ້ານ ໂພນນາດ	ບ້ານ ທົ່ງກອງ	ບ້ານ ໜອງແສງ				
ບ້ານ ໂຄກສະຫວ່າງ	ບ້ານ ກວນໂພ	ບ້ານ ຫາງການ	ບ້ານ ເຫຼົ້ານາງາມ				
ບ້ານ ພິດສີໄຂ່	ບ້ານ ນາເມືອງ	ບ້ານ ຊຽງດາວ	 				
ລະຫັດໄປສະນີ ເຂດ 3: 12043				
ບ້ານ ທ່າໂທດເໜືອ	ບ້ານ ບຸງເບົາ	ບ້ານ ໂພນທອຍ	ບ້ານ ຫາດຊອນ				
ບ້ານ ທົ່ງມັງ	ບ້ານ ຖ້ຳພະ	ບ້ານ ມ່ວງໄຂ່	ບ້ານ ແກ້ງມ່ວງ				
ບ້ານ ນາເທິດ	ບ້ານ ນາແວງ	ບ້ານ ຫ້ວຍວຽງ	ບ້ານ ທ່າຕາກແດດ				
ບ້ານ ຜານາງເຮືອງ	ບ້ານ ໂພນແສດ	ບ້ານ ນາພອງ	ບ້ານ ນາບໍ່				
ບ້ານ ສີວິໄລ	ບ້ານ ໂພນສັງ	ບ້ານ ໂພນແກ້ວ	ບ້ານ ບືງນາ				
 	 	 	ບ້ານ ສ້າງປຸ່ງບອນ				
ເມືອງ ບົວລະພາ ລະຫັດໄປສະນີ  12050 - 12053				
ລະຫັດໄປສະນີ ເຂດ 1: 12050				
ບ້ານ ທ່າກະຈັນ	ບ້ານ ຜານົບ	ບ້ານ ຫາດທະນາ	ບ້ານ ຊຳກາງ				
ບ້ານ ສົບເປງ	ບ້ານ ໜອງບົວ+ນາເພົາ	ບ້ານ ນາຕັ້ງໃຈ	ບ້ານ ນາພຽນລ້ານ				
ບ້ານ ນາຕອຍ	ບ້ານ ກະຈ່າມໃຫຍ່	ບ້ານ ແກ້ງວັກ	ບ້ານ ຫ້ວຍທາດ				
ບ້ານ ທ່າສະອາດ	ບ້ານ ຊອກ	ບ້ານ ໂພນກະແຕ້	ບ້ານ ເຄາະ				
ບ້ານ ວັງຄົນ	ບ້ານ ກະຈານນ້ອຍ	ບ້ານ ດຸ	ບ້ານ ແກ້ງຕາປາ				
ລະຫັດໄປສະນີ ເຂດ 2: 12051				
ບ້ານ ປ່າເກີນ	ບ້ານ ຖ້ຳລາວ	ບ້ານ ນາປາງ	ບ້ານ ໂພນສ້າງໄຟ				
ບ້ານ ປາຊິວ	ບ້ານ ລາດ	ບ້ານ ຍາເຫວດ	ບ້ານ ຊະຍູ້				
ບ້ານ ຈະໂນນ	ບ້ານ ບົວລະພາ	ບ້ານ ຫຼັງຄັງ	ບ້ານ ຍາຫວາຍ				
ບ້ານ ໜອງມ້າ	ບ້ານ ນາສົມບູນ	ບ້ານ ນາຈັດ	ບ້ານ ກາງ				
ບ້ານ ລະບ້ວຍ	ບ້ານ ນາເປງ	ບ້ານ ໂພນ	ບ້ານ ໂສຍ				
ລະຫັດໄປສະນີ ເຂດ 3: 12052				
ບ້ານ ໃໝ່	ບ້ານ ລ້າຍ	ບ້ານ ນ້ຳຈະຫຼ້າ	ບ້ານ ຕະລອງ				
ບ້ານ ນາແວ້	ບ້ານ ໜອງໜ້ຽວ	ບ້ານ ກະແຕະ	ບ້ານ ປາກພະນັງ				
ບ້ານ ຜາຂຽດ	ບ້ານ ມູກ	ບ້ານ ຫີນລັບ	ບ້ານ ໜອງປິງ				
ບ້ານ ໂຄກ	ບ້ານ ງືກ	ບ້ານ ນາປຸ່ງ	ບ້ານ ທົ່ງຂາມ				
ບ້ານ ທ່າ	ບ້ານ ທາງແບ່ງ	ບ້ານ ປ່າກ້ວຍ	ບ້ານ ນາຫ້ອມ				
ລະຫັດໄປສະນີ ເຂດ 4: 12053				
ບ້ານ ທາດ	ບ້ານ ໜອງແສງ	ບ້ານ ປ່າກ້ວຍ	ບ້ານ ລະຈັງ				
ບ້ານ ແສນພັນ	ບ້ານ ໜອງໂນ	ບ້ານ ນາສະລອນ	ບ້ານ ກະອີ				
ບ້ານ ໂກນຂະໂຫຍນ	ບ້ານ ໜອງກະບາດ	ບ້ານ ຫ້ວຍແຫດ	ບ້ານ ຈະແລດ				
ບ້ານ ສະອາງ	ບ້ານ ວັງເງືອກ	ບ້ານ ຄວາຍແມບ	ບ້ານ ວັງຫຼວງ				
ບ້ານ ວັງມະເນີ	ບ້ານ ນ້ຳອອກຮູ	ບ້ານ ໜອງກຸ້ງ	ບ້ານ ໂຮງ				
ເມືອງ ເຊບັ້ງໄຟລະຫັດໄປສະນີ  12060 - 12062 				
ລະຫັດໄປສະນີ ເຂດ 1: 12060				
ບ້ານ ທ່າສີດາ	ບ້ານ ສັງ	ບ້ານ ສ້ອມ	ບ້ານ ຫາດເຜັກ				
ບ້ານ ນາພອນເກົ່າ	ບ້ານ ໂພນດີທົ່ງ	ບ້ານ ແກ້ງແປ	ບ້ານ ໜອງບອນ				
ບ້ານ ຍາງຄຳ	ບ້ານ ກົກຕ້ອງ	ບ້ານ ໂນນກະແຕ້	ບ້ານ ຂົວເຊ				
ບ້ານ ນາບືງ	ບ້ານ ຖ້ຳລາຍ	ບ້ານ ນາຊອຍ	ບ້ານ ວັງເດືອນ				
ລະຫັດໄປສະນີ ເຂດ 2: 12061				
ບ້ານ ຫາດຄຳຮຽງ	ບ້ານ ຕືງ	ບ້ານ ຫ້ວຍລ້າງມື	ບ້ານ ທ່າຫາດ				
ບ້ານ ບືງຫົວນາ	ບ້ານ ດົງໝາກບ້າ	ບ້ານ ນ້ອຍ	ບ້ານ ຊອກມໍ				
ບ້ານ ບືງຫົວນາກາງ	ບ້ານ ໜອງພັງ	ບ້ານ ທ່າຄໍ້	 				
ລະຫັດໄປສະນີ ເຂດ 3: 12062				
ບ້ານ ກະພະ	ບ້ານ ໂຄກແກ້ງແຄນ	ບ້ານ ໂຄກຂີ້ໜີ້ນ	ບ້ານ ແກ້ງແຄນ				
ບ້ານ ນາທານ	ບ້ານ ເວີນສະນັ້ນ	ບ້ານ ທັບ	ບ້ານ ເຊນ້ອຍ				
ບ້ານ ຍາງໃຫຍ່	ບ້ານ ນາຄອມເກົ່າ	ບ້ານ ໂຄກສະຫວ່າງ	ບ້ານ ຄຳເຕີຍ				
ບ້ານ ສົ້ມ	ບ້ານ ນາຄອມທົ່ງ	ບ້ານ ປົ່ງແດງ	ບ້ານ ດອນສະອາດ				
ເມືອງ ນາກາຍ ລະຫັດໄປສະນີ  12070 - 12073				
ລະຫັດໄປສະນີ ເຂດ 1: 12070				
ບ້ານ ອຸດົມສຸກ	ບ້ານ ນາຫ່າງ	ບ້ານ ວັງຢ້ຽມ	ບ້ານ ທົງຊາດ				
ບ້ານ ບົວມາ	ບ້ານ ນາທົນ	ບ້ານ ດ່ານ	ບ້ານ ຝັງແດງ				
ບ້ານ ສົບແພນ	ບ້ານ ນາບອນ	ບ້ານ ດົງໂພສີ	ບ້ານ ນາຫາວ				
ບ້ານ ນາຕານ	ບ້ານ ນາເມືອງ	ບ້ານ ນາວາງ	ບ້ານ ທ່າເມືອງ+ຕານດຸ				
ລະຫັດໄປສະນີ ເຂດ 2: 12071				
ບ້ານ ກະຈີງ	ບ້ານ ນາກາຍໄຕ້	ບ້ານ ໜອງບົວ	ບ້ານ ຜາດ່າງ				
ບ້ານ ນາແມວ	ບ້ານ ນາກາຍເໜືອ	ບ້ານ ດອນ	ບ້ານ ໂພນຄ້ຳ				
ບ້ານ ໝາກກາ	ບ້ານ ສົບອອນ	ບ້ານ ກະໂອຍ	ບ້ານ ນາກາງ				
ບ້ານ ປຸ່ງ	ບ້ານ ສົບມາ	ບ້ານ ທ່າຂັນແກ້ວ	ບ້ານ ເມືອງຫຼາງ				
ລະຫັດໄປສະນີ ເຂດ 3: 12072				
ບ້ານ ໂພນຄ້ຳ	ບ້ານ ໝາກເຟືອງ	ບ້ານ ນາເມີຍ	ບ້ານ ຂອນແກ່ນ				
ບ້ານ ວັງຫີນ	ບ້ານ ຊອກແຫຼກ	ບ້ານ ໂພນສະຫວ່າງ	ບ້ານ ກວນສານ				
ບ້ານ ສອງຄອນ	ບ້ານ ວັງຈ້າງ	ບ້ານ ໜອງບົວຄຳ	 				
ບ້ານ ທ່າໄຜ່ບ້ານ	ບ້ານ ບຶງ	ບ້ານ ທ່າລັງ	 				
ລະຫັດໄປສະນີ ເຂດ 4: 12073				
ບ້ານ ດອກແກ້ວ	ບ້ານ ທົ່ງ	ບນ ສີງທອງ	ບ້ານ ປືກ				
ບ້ານ ນາສີດາ	ບ້ານ ຍາງ	ບ້ານ ເຕີງ	ບ້ານ ວັງແຫຼ				
ບ້ານ ກວນ	ບ້ານ ນາຫວ້າ	ບ້ານ ວັງຄວາຍ	ບ້ານ ຕອງ				
ບ້ານ ຊົ້ງ	ບ້ານ ກໍບົງ	ບ້ານ ປື	 				
ເມືອງ ໄຊບົວທອງ ລະຫັດໄປສະນີ 12080 - 12083				
ລະຫັດໄປສະນີ ເຂດ 1: 12080				
ບ້ານ ນາຂາມນ້ອຍ	ບ້ານ ນາຄຳຈວງໄຕ້	ບ້ານ ນາຄຳພັນ	ບ້ານ ນາພ້າວ				
ບ້ານ ນາລະອອງ	ບ້ານ ນາຄຳຈວງເໜືອ	ບ້ານ ໂພນສະອາດ	ບ້ານ ເຫຼົ່າ				
ບ້ານ ນາກະດອມ	ບ້ານ ໄຮ່ໝອງບົວ	ບ້ານ ໂພນສະຫວ່າງ	ບ້ານ ໝອງຜຶ				
ບ້ານ ໜອງທາດ	ບ້ານ ຜາຫອຍ	ບ້ານ ຍາງ	ບ້ານ ກຸດນ້ຳໃສ				
ລະຫັດໄປສະນີ ເຂດ 2: 12081				
ບ້ານ ດົງປາງ	ບ້ານ ສີວິໄລ	ບ້ານ ນາຮັງ	ບ້ານ ນານົກ				
ບ້ານ ທ່າກົກແຄນ	ບ້ານ ຕໍເຮືອດ	ບ້ານ ແກ້ງຈອນ	ບ້ານ ນາບອນ				
ບ້ານ ນາໂມ້ເໜືອ	ບ້ານ ນາຫລວງ	ບ້ານ ໂພນສະຫວັນ	ບ້ານ ຊອກທາງໄຕ້				
ບ້ານ ນາກະທິງ	ບ້ານ ຜາສອງ	ບ້ານ ນາປ່າຄາ	ບ້ານ ນາໝາກໝີ້ດົງ				
ລະຫັດໄປສະນີ ເຂດ 3: 12082				
ບ້ານ ຜາຂາດ	ບ້ານ ຜາສະຫວາ	ບ້ານ ນາໂມ້ໄຕ້	ບ້ານ ຜາໂຄ້ງໄຕ້				
ບ້ານ ຜາສະງີມ	ບ້ານ ດົງນາຄຳ	ບ້ານ ປ່າກ້ວຍດົງ	ບ້ານ ຊອກທາງເໜືອ				
ບ້ານ ໂພນນາດິ	ບ້ານ ກໍບົງ	ບ້ານ ປ່າກ້ວຍທົ່ງ	 				
ບ້ານ ຫ້ວຍໂຄນ	ບ້ານ ນ້ຳກະບໍ	ບ້ານ ຜາໂຄ້ງເໜືອ	 	 			
ລະຫັດໄປສະນີ ເຂດ 4: 12083				
ບ້ານ ນາຄອງ	ບ້ານ ນານ້ອຍທົ່ງ	ບ້ານ ປ່າກະແສ	ບ້ານ ໂພນວິໄລ				
ບ້ານ ກະແສ	ບ້ານ ນາໝາກໝີ້ທົ່ງ	ບ້ານ ທົ່ງຕຽມ	ບ້ານ ຫົວຂົວ				
ບ້ານ ນາຮີ	ບ້ານ ວັງຫີນ	ບ້ານ ແກ້ງໜື່ນ	ບ້ານ ນາຊຽງຄວນ				
ບ້ານ ນານ້ອຍດົງ	ບ້ານ ສົມບູນ	ບ້ານ ປ່າກ້ວຍໜອງບອນ	 				
ເມືອງ ຄູນຄຳ ລະຫັດໄປສະນີ 12090 - 12093				
ລະຫັດໄປສະນີ ເຂດ 1: 12090				
ບ້ານກອງລໍເໜືອນ	ບ້ານ ວັງດາວ	ບ້ານ ຫ້ວຍແກ້ວ	ບ້ານ ໂພນທອງ				
ບ້ານ ອໍ້	ບ້ານ ແກ້ງຄົດ	ບ້ານ ນາເມືອງ	ບ້ານ ກົງພັດ				
ບ້ານ ຄູນເງິນ	ບ້ານ ມ່ວງເໜືອນ	ບ້ານ ມ່ວງນ້ຳສາງ	ບ້ານ ທົ່ງລົມ				
ບ້ານ ຖໍ້າແຕ້ມ	ບ້ານ ແກ້ງ		 				
ລະຫັດໄປສະນີ ເຂດ 2: 12091				
ບ້ານ ຜາຮ່າງໃຕ້	ບ້ານ ໜອງດົງ	ບ້ານ ນ້ຳສະນາມ	ບ້ານ ໂພນແຍງ				
ບ້ານ ຜາຈົວ	ບ້ານ ກອງລໍກາງ	ບ້ານ ດອນ	ບ້ານ ນາກາງເໜືອນ				
ບ້ານ ນາຄາ	ບ້ານ ຍາງ	ບ້ານ ນາສະກອງ	ບ້ານ ນາຄຳ				
ບ້ານ ສອງຄອນ	ບ້ານ ຄູນຄຳ	 	 				
ລະຫັດໄປສະນີ ເຂດ 3: 12092				
ບ້ານ ນາຕົງ	ບ້ານ ທະນາເໜືອນ	ບ້ານ ປາກທຶບ	ບ້ານ ກູບ				
ບ້ານ ຜາຄ້ອງ	ບ້ານ ຫ້ວຍເປືອກ	ບ້ານ ນາເຕີຍ	ບ້ານ ນາຂາມ				
ບ້ານ ຫາດຄ້າງ	ບ້ານ ວັງມົນ	ບ້ານ ກອງລໍໃຕ້	ບ້ານ ກາງ				
ບ້ານ ນາຄົກ			 				
ລະຫັດໄປສະນີ ເຂດ 4: 12093				
ບ້ານ ຜາໂກນໂກ	ບ້ານ ນາຊ້າງຂ້າມ	ບ້ານ ນາພວກ	ບ້ານ ຜັງແດງ				
ບ້ານ ແຄນ	ບ້ານ ນ້ຳມະຫ່າງ	ບ້ານ ຜາຫ່າງເໜືອ	ບ້ານ ນ້ຳສ້າງ				
ບ້ານ ນ້ຳນ້ອຍ	ບ້ານ ໜອງຫ່າງ	ບ້ານ ທະນາໃຕ້	ບ້ານ ປາກແບ່ງ				
ບ້ານ ນາກາງໃຕ້	 	 	 				



ແຂວງ ສະຫວັນນະເຂດ
ເລກລະຫັດໄປສະນີ 13000
ແຂວງ ສະຫວັນນະເຂດ 13xxx				
ເມືອງ ໄກສອນພົມວິຫານ ລະຫັດໄປສະນີ  13000 - 13003  				
ລະຫັດໄປສະນີ ເຂດ 1: 13000				
ບ້ານໄຊຍະພູມ	ບ້ານ ທ່າແຮ	ບ້ານ ນາເລົ່າ	ບ້ານ ນາແກ				
ບ້ານລັດຕະນະລັງສີເໜືອ	ບ້ານ ລາດສະວົງໄຊ	ບ້ານ ສະໜາມໄຊ	ບ້ານ ໂພໄຊ				
ບ້ານລັດຕະນະລັງສີໄຕ້	ບ້ານ ສຸນັນທາ	ບ້ານ ໂນນສະຫວາດ	ບ້ານ ຫົວເມືອງເໜືອ				
ບ້ານ ໄຊຍະມຸງຄຸນ	ບ້ານ ທ່າເມືອງ	ບ້ານ ຈອມແກ້ວ	ບ້ານ ຫົວເມືອງໄຕ້				
ລະຫັດໄປສະນີ ເຂດ 2: 13001				
ບ້ານ ວຽງສະຫວັນ	ບ້ານ ໜອງເດີນ	ບ້ານ ນາເຊັງ	ບ້ານ ໂພນສະອາດ				
ບ້ານ ໂພນສະຫວ່າງໄຕ້	ບ້ານ ໜອງຜື	ບ້ານ ໂພນຊາຍ	ບ້ານ ສອນໄຊ				
ບ້ານ ໂພນສະຫວ່າງເໜືອ	ບ້ານ ສະພານເໜືອ	ບ້ານ ສະພານໄຕ້	ບ້ານ ດອນເຊັງ				
ບ້ານ ອຸດົມວິໄລ	ບ້ານ ດົງດຳດວນ	ບ້ານ ໂພນສະຫວັນ	ບ້ານ ຜັກຂະ				
ລະຫັດໄປສະນີ ເຂດ 3: 13002				
ບ້ານ ນາໂພ	ບ້ານ ຊອກ	ບ້ານ ບຶງວະ	ບ້ານ ດົງຄຳຫຼວງ				
ບ້ານ ສົ້ມປ່ອຍ	ບ້ານ ຍາງສູງ	ບ້ານ ຫ້ວຍ	ບ້ານ ສົມສະອາດ				
ບ້ານ ໂນນອຸດົມ	ບ້ານ ໂພນສູງ	ບ້ານ ແກ້ງຫີນສູງ	ບ້ານ ຊອກວາງ				
ບ້ານ ຫ້ວຍໄຜ່	ບ້ານ ດົງໝາກຢາງ	ບ້ານ ດົງນາຄຳ	ບ້ານ ນາກອຍ				
ລະຫັດໄປສະນີ ເຂດ 4: 13003				
ບ້ານ ທາດອີງຮັງ	ບ້ານ ເຄືອເຂົາກາດ	ບ້ານ ດົງດຳດວນ	ບ້ານ ທ່າຊະໂນ				
ບ້ານ ໂພນສິມ	ບ້ານ ຍາງໂພສີ	ບ້ານ ເລົ່າງາມ	ບ້ານ ບຶງທະເລ				
ບ້ານ ສົ້ງ	ບ້ານ ໝໍເມືອງ	ບ້ານ ຂອນແກ່ນ	ບ້ານ ນ້ຳບໍ່				
ບ້ານ ນາເຕີຍ	ບ້ານ ໜອງໂກ່ມ	ບ້ານ ຕົ້ນເຜີ້ງ	ບ້ານ ທ່າຫົວຊ້າງ				
ບ້ານ ດົງບັງ	ບ້ານ ນາຈະຫຼີດ	ບ້ານ ປາກບໍ່	 				
ເມືອງ ອຸທຸມພອນ ລະຫັດໄປສະນີ  13010-13013				
ລະຫັດໄປສະນີ ເຂດ 1: 13010				
ບ້ານເຊໂນ	ບ້ານ ໄຊສົມບູນ	ບ້ານ ຈອມເພັດ	ບ້ານ ໜອງອາຮົງ				
ບ້ານ ມະນີວົງໄຊ	ບ້ານ ອຸດົມມີໄຊ	ບ້ານ ຈະເລີນສຸກ	ບ້ານ ສະໜາມໄຊ				
ບ້ານ ຈັນທະລັງສີ	ບ້ານ ໄຊຍະມຸງຄຸນ	ບ້ານ ໄຊອຸດົມ	ບ້ານ ໄຊສະອາດ				
ບ້ານ ວົງພັນສີ	ບ້ານ ນາທາດ	ບ້ານ ໂນນດອກໄມ້	ບ້ານ ໜອງຄຳແຮດ				
ບ້ານ ໄຊຍະເພັດ			 				
ລະຫັດໄປສະນີ ເຂດ 2: 13011				
ບ້ານ ຫ້ວຍເໝົ້າ	ບ້ານ ດົງໝາກແງວ	ບ້ານ ໂພນເດືອ	ບ້ານ ນາຫົວຂົວ				
ບ້ານ ຫ້ວຍສັງທອງ	ບ້ານ ຜັກຂະຫຍ່າ	ບ້ານ ໂພນຕູມ	ບ້ານ ໂນນນາຄູນ				
ບ້ານ ກາງໂພສີ	ບ້ານ ສົມສະອາດ	ບ້ານ ໂພນສະຫວາງ	ບ້ານ ນາໂພ				
ບ້ານ ນາຄູ	ບ້ານ ນາສະໂນດ	ບ້ານ ໂພຢານາງ	ບ້ານ ນາເກງ				
ບ້ານ ສົມພັດວິໄລ	 	 	 				
ລະຫັດໄປສະນີ ເຂດ 3: 13012				
ບ້ານ ນາປົງ	ບ້ານ ດົງໃນ	ບ້ານ ທົ່ງ	ບ້ານ ໂພນຕາດ				
ບ້ານ ປ່າໝາມ	ບ້ານ ໜອງແປນ	ບ້ານ ນາ	ບ້ານ ໜອງບົວທອງ				
ບ້ານ ໂນນອຸດົມ	ບ້ານ ນາຄຳ	ບ້ານ ນາຂີ້ເຫຼັກ	ບ້ານ ກີບມ້າ				
ບ້ານ ດົງທ່າ	ບ້ານ ຕາດຂາແດງ	ບ້ານ ສະກຸດ	ບ້ານ ໂພນໜາກຫຍ້າ				
ບ້ານ ໂນນປ່າໄຫຼ			 				
ລະຫັດໄປສະນີ ເຂດ 4: 13013				
ບ້ານ ດົງນ້ອຍ	ບ້ານ ເລົ່າໃຫຍ່	ບ້ານ ພີນໄຕ້	ບ້ານ ໂຄກ				
ບ້ານ ຫົວຄຳ	ບ້ານ ແມດ	ບ້ານ ນາຈານ	ບ້ານ ນາຊາຍ				
ຍ້ານ ນາກະເຊາະ	ບ້ານ ໂນນວິໄລ	ບ້ານ ໂນນຢາງ	ບ້ານ ໂພນທັນ				
ບ້ານ ກຸດແຂ້	ບ້ານ ພີນເໜືອ	ບ້ານ ໂນນສະຫວາງ	 				
ບ້ານ ຖ້ຳພະ	ບ້ານ ພີນກາງ	ບ້ານ ສີບຸນເຮືອງ	 				
ເມືອງ ອາດສະພັງທອງ ລະຫັດໄປສະນີ 13020 - 13022 				
ລະຫັດໄປສະນີ ເຂດ 1: 13020				
ບ້ານ ແຈມະລອງ	ບ້ານ ວັດທະນາສົມບູນ	ບ້ານ ໄລກະທະ	ບ້ານ ຕະບອງເພັດ				
ບ້ານ ດົງເຫັນ	ບ້ານ ຫົວເມືອງ	ບ້ານ ດົງກຶມ	ບ້ານ ໂນນຮັງ				
ບ້ານ ນາແກ	ບ້ານ ໂພນບົກ	ບ້ານ ສາມັກຄີໄຊ	ບ້ານ ໂຄກສະຫວ່າງ				
ບ້ານ ຫຼຽນໄຊ	ບ້ານ ນາຫຼັກ	ບ້ານ ດົງກິໂລ	ບ້ານ ປົ່ງດົງ				
ລະຫັດໄປສະນີ ເຂດ 2: 13021				
ບ້ານ ປົ່ງນາ	ບ້ານ ໜອງໃສ	ບ້ານ ຫ້ອຍ	ບ້ານ ໜອງຫອຍ				
ບ້ານ ດົງຂວາງ	ບ້ານ ໂພນງອຍ	ບ້ານ ນາພັງໂຄກ	ບ້ານ ດອນປ່າໄລ່				
ບ້ານ ນາສະຫວ່າງ	ບ້ານ ປ່າໄລ່	ບ້ານ ໂພສີແກ້ວ	ບ້ານ ໜອງປາກຊ່ອງ				
ລະຫັດໄປສະນີ ເຂດ 3: 13022				
ບ້ານ ໂພນຜາງ	ບ້ານ ສີວິໄລ	ບ້ານ ນາໄລ່ໂຄກ	ບ້ານ ນາຄຳໃຕ້				
ບ້ານ ສະພັງແກ້ວ	ບ້ານ ນານ້ຳທ່ຽງ	ບ້ານ ນາໄລ່ດົງ	ບ້ານ ນາແສນແກ້ວ				
ບ້ານ ນາຈານ	ບ້ານ ພັງໂຮ	ບ້ານ ດົງນາຂາມ	ບ້ານ ດົງໝາກກໍ່				
ເມືອງ ພີນ ລະຫັດໄປສະນີ 13030 - 13035				
ລະຫັດໄປສະນີ ເຂດ 1: 13030				
ບ້ານ ເວີນຫົງຄຳ	ບ້ານ ພອນ	ບ້ານ ໃໝ່ໂນນສະອາດ	ບ້ານ ນາກະຫານ				
ບ້ານ ປະສົມໄຊ	ບ້ານ ສະຄວງ	ບ້ານ ໂຄກປູນ	ບ້ານ ນາທະລັງ				
ບ້ານ ພີນ	ບ້ານ ນາເປາະ	ບ້ານ ເທີ້ມໃໝ່	ບ້ານ ໂນນຍາງ				
ບ້ານ ນາໂພ	ບ້ານ ນາຂະເໜາະ	ບ້ານ ເທີ້ມເກົ່າ	ບ້ານ ສະລອຍ				
ບ້ານ ນາຈານ	 	 	 				
ລະຫັດໄປສະນີ ເຂດ 2: 13031				
ບ້ານ ຫີນສະໂງມ	ບ້ານ ລະຕຶບ	ບ້ານ ກອຍ	ບ້ານ ຫ້ວຍຫອຍເໜືອ				
ບ້ານ ອາປອກ	ບ້ານ ແກ້ງກະແທັງ	ບ້ານ ຊະນະມີໄຊ	ບ້ານ ແກ້ງອາເລີງ				
ບ້ານ ມະລົວ	ບ້ານ ໂນນໄຊ	ບ້ານ ສີບຸນເຮືອງ	ບ້ານ ທູນຂາມ				
ບ້ານ ຂະໝິນ	ບ້ານ ດົງພູເງິນ	ບ້ານ ປ່າເຫຼັກ	ບ້ານ ປະຕອງ				
ບ້ານ ວັງບ້ວງ			 				
ລະຫັດໄປສະນີ ເຂດ 3: 13032				
ບ້ານ ປະອົກ	ບ້ານ ກາງເກົ່າ	ບ້ານ ກະຢັອງ	ບ້ານ ນາໂພຄຳ				
ບ້ານ ສະລູ	ບ້ານ ໄຊສົມບູນ	ບ້ານ ກາງໃໝ່	ບ້ານ ນາທົ່ມເກົ່າ				
ບ້ານ ຫ້ວຍສິງ	ບ້ານ ເຊສະຫວ່າງ	ບ້ານ ໃໝ່ເລກ 9	ບ້ານ ຄຳສະອີ				
ບ້ານ ອາລານ	ບ້ານ ອຸດົມໄຊ	ບ້ານ ຕະມູບ	ບ້ານ ນາແຊງເກົ່າ				
ບ້ານ ສົງເປືອຍ			 				
ລະຫັດໄປສະນີ ເຂດ 4: 13033				
ບ້ານ ນາຄະນົງ	ບ້ານ ໜອງຫຼວງ	ບ້ານ ອາລວຍຄຳນ້ອຍ	ບ້ານ ສະແລໂພໄຊ				
ບ້ານ ຫ້ວຍຊາຍ	ບ້ານ ນາທູ້	ບ້ານ ຂອນແກ່ນ	ບ້ານ ອານຸສັນຍາ				
ບ້ານ ພະລອງ	ບ້ານ ອາລວຍໃໝ່	ບ້ານ ສະແລເໜືອ	ບ້ານ ນາທົ່ມໂຄກ				
ບ້ານ ພະລູ	ບ້ານ ນາທອງ	ບ້ານ ສະແລໃຕ້	ບ້ານ ຕາດໄຮເຊ				
ບ້ານ ສົມສະອາດ		 	 				
ລະຫັດໄປສະນີ ເຂດ 5: 13034				
ບ້ານ ລະກາຍ	ບ້ານ ໂນນໄຊ	ບ້ານ ໂນນວິໄລ	ບ້ານ ໜອງບົວ				
ບ້ານ ນາປາງ	ບ້ານ ກະແມບເຊ	ບ້ານ ທົ່ງນາມີ	ບ້ານ ນາເພັກ				
ບ້ານ ບອຍ	ບ້ານ ແກ້ງກົວະ	ບ້ານ ຕັ້ງອາໄລ	ບ້ານ ຍາງ				
ບ້ານ ແກ້ງສະລັງ	ບ້ານ ແກະ	ບ້ານ ບົກ	ບ້ານ ວົງສີແກ້ວ				
ບ້ານ ຕາດໄຮໂຄກ		 	 				
ລະຫັດໄປສະນີ ເຂດ 6: 13035				
ບ້ານ ໂພນໄຊ	ບ້ານ ປາເຊ໋ຍ	ບ້ານ ພະລອງ	ບ້ານ ປະໂທງ				
ບ້ານ ປະສິດ	ບ້ານ ກະປຸງ	ບ້ານ ໂນນສູງ	ບ້ານ ສົບບອນ				
ບ້ານ ແກ້ງໄຊ	ບ້ານ ໃຜ່	ບ້ານ ອາເປຍ	ບ້ານ ຫ້ວຍຫອຍໃຕ້				
ບ້ານ ອາເລົາເກົ່າ	ບ້ານ ສະວື	ບ້ານ ຊ້າງແທງ	ບ້ານ ຫ້ວຍຫອຍກາງ				
ບ້ານ ອາເລົາໃໝ່			 				
ເມືອງ ເຊໂປນ ລະຫັດໄປສະນີ 13040-13044				
ລະຫັດໄປສະນີ ເຂດ 1: 13040				
ບ້ານ ລູສະເລຍ	ບ້ານ ນາ	ບ້ານ ລະອານ	ບ້ານ ກະລາກ				
ບ້ານ ລະເວີນ	ບ້ານ ຈະປອງ	ບ້ານ ກົກໝາກ	ບ້ານ ລະໂກ				
ບ້ານ ຕະປອງ	ບ້ານ ຜາບັງ	ບ້ານ ຕະເບືອ	ບ້ານ ປະຢຸຍ				
ບ້ານ ກອກ	ບ້ານ ໃໝ່	ບ້ານ ລະງີ	ບ້ານ ສະດູນ				
ບ້ານ ສົບລູ	ບ້ານ ນ້ຳໂທນ	ບ້ານ ອາວຽນ	ບ້ານ ສະແລນ				
ລະຫັດໄປສະນີ ເຂດ 2: 13041				
ບ້ານ ໃໝ່ສະກີ	ບ້ານ ຕູບໃຫຍ່	ບ້ານ ສະໜູນ	ບ້ານ ດົງໃຫຍ່				
ບ້ານ ຕໍເຮືອ	ບ້ານ ມະຮາດ	ບ້ານ ແກ້ງກົກ	ບ້ານ ອາຫໍ				
ບ້ານ ລະເຕືອງ	ບ້ານ ກະແຫຼງ	ບ້ານ ກະດັບ	ບ້ານ ແກ້ງແມວ				
ບ້ານ ອາກິງ	ບ້ານ ຈຽງ	ບ້ານ ສະກີພີນ	ບ້ານ ແກ້ງຫຼວງ				
ບ້ານ ຕູບນ້ອຍ	ບ້ານ ວັງບິງ		 				
ລະຫັດໄປສະນີ ເຂດ 3: 13042				
ບ້ານ ປ່າໄລ່	ບ້ານ ເມືອງຈັນ	ບ້ານ ວັງແຍງ	ບ້ານ ຫົວຍື່ງ				
ບ້ານ ລະຄືມ	ບ້ານ ເມືອງແສນ	ບ້ານ ແຄວີນ	ບ້ານ ສະແກງ				
ບ້ານ ກະແຫຼງກາງ	ບ້ານ ຫ້ວຍແຈງ	ບ້ານ ຫ້ວຍຕ້ອນ	ບ້ານ ຫົວນາ				
ບ້ານ ອາລາງ	ບ້ານ ເຊໂປນ	ບ້ານ ໂພໂລະ	ບ້ານ ຊຽງຮົ່ມ				
ບ້ານ ອາໄລ	ບ້ານ ສົບເຊ		 				
ລະຫັດໄປສະນີ ເຂດ 4: 13043				
ບ້ານ ດູນ	ບ້ານ ລາດຫໍ້	ບ້ານ ແກ້ງຄຶບ	ບ້ານ ແກ້ງຫົວປາ				
ບ້ານ ຕ້າຍ	ບ້ານ ນາໂທນ	ບ້ານ ວັງໝໍ້ທຸ້ມ	ບ້ານ ລະອໍ				
ບ້ານ ສະແຫວງ	ບ້ານ ວັງໄຮ	ບ້ານ ສົບມີ່	ບ້ານ ແກ້ງກີວ				
ບ້ານ ປະງາ	ບ້ານ ລາດ	ບ້ານ ທ່າແມະ	ບ້ານ ມັນຈີ				
ລະຫັດໄປສະນີ ເຂດ 5: 13044 				
ບ້ານ ນາຫຼວງ	ບ້ານ ເຟືອງ	ບ້ານ ສອນມີໄຊ	ບ້ານ ນາບໍ່				
ບ້ານ ລະໂບກາງ	ບ້ານ ຫ້ວຍສານ	ບ້ານ ອຸດົມສຸກ	ບ້ານ ໂພນໄຮ				
ບ້ານ ວັງກຸງ	ບ້ານ ດົງສະຫວັນ	ບ້ານ ວົງວິໄລ	ບ້ານ ໂພໄຊ				
ບ້ານ ແດນສະຫວັນ	ບ້ານ ທ່າໂຄ່ງ	ບ້ານ ໂພນມ່ວງ	 				
ເມືອງ ຈຳພອນ ລະຫັດໄປສະນີ 13050 - 13054				
ລະຫັດໄປສະນີ ເຂດ 1: 13050				
ບ້ານ ແກ້ງກອກດົງ	ບ້ານ ດົງນາຄອຍ	ບ້ານ ນາຄູ	ບ້ານ ນາກະທະ				
ບ້ານ ແກ້ງກອກກາງ	ບ້ານ ພະແລ໋ງ	ບ້ານ ດອນແດງ	ບ້ານ ດົງຕາແດງ				
ບ້ານ ແກ້ງກອກເໜືອ	ບ້ານ ດົງຄຳໝື່ນ	ບ້ານ ຕະແຫຼວ	ບ້ານ ໜອງກະໂດກ				
ບ້ານ ແກ້ງກອກທົ່ງ	ບ້ານ ຫົວເມືອງ	ບ້ານ ຕະແຫຼວນ້ອຍ	ບ້ານ ທວດ				
ບ້ານ ດົງໜອງຂຸນ	ບ້ານ ໂນນວິໄລວັນ	ບ້ານ ນາຕ້າຍ	ບ້ານ ນາຂາມ				
ລະຫັດໄປສະນີ ເຂດ 2: 13051				
ບ້ານ ນາໄຮ່ດຽວ	ບ້ານ ໜອງລຳຈັນ	ບ້ານ ໜອງອີງ	ບ້ານ ຄຳສີດາ				
ບ້ານ ລຳບອງ	ບ້ານ ເຊ	ບ້ານ ຫົວນ້ຳສ້າງ	ບ້ານ ເລົາໜາກຂ່າ				
ບ້ານ ວັງເມົາ	ບ້ານ ຫ້ວຍເຍົາ	ບ້ານ ຕານສຸມ	ບ້ານ ບົກ				
ບ້ານ ລຳເທນ	ບ້ານ ຕຳຕອງລອງ	ບ້ານ ດອນເຄັງ	ບ້ານ ເລົາຫົວຄຳ				
ບ້ານ ເພຍກາ	ບ້ານ ແສນ	ບ້ານ ເລົາໜາດ	ບ້ານ ຫ້ວຍຊາຍ				
ລະຫັດໄປສະນີ ເຂດ 3: 13052				
ບ້ານ ກະດານ	ບ້ານ ຄຳນ້ອຍ	ບ້ານ ດົງຄັນຄູ	ບ້ານ ໜອງກະລ໋ອງ				
ບ້ານ ດົງກວງໂຕນ	ບ້ານ ນາສານ	ບ້ານ ຄຳແຄນ	ບ້ານ ນານົກຂຽນ				
ບ້ານ ບາກ	ບ້ານ ເຂົາກາດ	ບ້ານ ໜອງເປັດ	ບ້ານ ດົງນາມອນ				
ບ້ານ ນາເຕີຍ	ບ້ານ ຍາງສູງ	ບ້ານ ຫ້ວຍຍາງ	ບ້ານ ສີທອງ				
ບ້ານ ໄຜ່	ບ້ານ ຂອນແຕ້	ບ້ານ ສີວິໄລ	ບ້ານ ຂາມເຖົ້າ				
ບ້ານ ຫຼັກ 35	ບ້ານ ໜອງຫົງ		 				
ລະຫັດໄປສະນີ ເຂດ 4: 13053				
ບ້ານ ຄໍ້	ບ້ານ ວັດທະນະທຳ	ບ້ານ ແກ້ງປູນ	ບ້ານ ດົງເມືອງ				
ບ້ານ ໜອງແວງ	ບ້ານ ໄຜລ້ອມ	ບ້ານ ໂນນສີທັນ	ບ້ານ ທ່າເມືອງ				
ບ້ານ ດົງດອກໄມ້	ບ້ານ ບືກດົງ	ບ້ານ ສະຄືນເໜືອ	ບ້ານ ດົງໝີ				
ບ້ານ ໂຄກແລ້ງ	ບ້ານ ໂພນທອງ	ບ້ານ ສະຄືນໄຕ້	ບ້ານ ໂພນສະອາດ				
ບ້ານ ບືກທົງ	ບ້ານ ດອນແຍງ	ບ້ານ ທ່າມ່ວງ	ບ້ານ ໂພນໂດກ				
ລະຫັດໄປສະນີ ເຂດ 5: 13054				
ບ້ານ ໂພນມ່ວງ	ບ້ານ ກຸດບອນ	ບ້ານ ເລົາສຸລິຍະ	ບ້ານ ກະຫຼາງເໜືອ				
ບ້ານ ໂພນສູງ	ບ້ານ ມ່ວງໄຂ່	ບ້ານ ໂນນຮັງ	ບ້ານ ກະຫຼາງໄຕ້				
ບ້ານ ໜອງຫຍ້າມ້າ	ບ້ານ ໂພນຕາດ	ບ້ານ ນອງໄຮ	ບ້ານ ປ່າກ້ວຍ				
ບ້ານ ໂນນສູງ	ບ້ານ ສີບຸນເຮືອງ	ບ້ານ ພັງເຮງ	ບ້ານ ຄຳປ່າແໜ				
ບ້ານ ຍືກຕະຫຼຸງ	ບ້ານ ດົງໝາກກໍ່	ບ້ານ ນາເຊືອກ	ບ້ານ ນົກກົກ				
ເມືອງ ສອງຄອນ ລະຫັດໄປສະນີ 13060 - 13064				
ລະຫັດໄປສະນີ ເຂດ 1: 13060				
ບ້ານ ປາກຊ່ອງ	ບ້ານ ໂຊກໄຊ	ບ້ານ ມະໄລທອງ	ບ້ານ ໂນນສົມພູ				
ບ້ານ ລັດຕະນະລາສີ	ບ້ານ ນາຄຳນົນ	ບ້ານ ໂນນຝາຍ	ບ້ານ ໜອງນົກຂຽນ				
ບ້ານ ສາລາຄຳ	ບ້ານ ທົງສີເມືອງ	ບ້ານ ນາກາລາ	ບ້ານ ອຸ່ມນາມຄອງ				
ບ້ານ ນວນວິໄລ	ບ້ານ ໜອງຍໍ	ບ້ານ ໜອງໄຮ່	ບ້ານ ນາພວກ				
ບ້ານ ເຫຼັກເມືອງ	ບ້ານ ໂຄກສະອາດ	ບ້ານ ໂນນສົມບູນ	 				
ລະຫັດໄປສະນີ ເຂດ 2: 13061				
ບ້ານ ນາຫອຍບັງ	ບ້ານ ໄໝ່ໜອງຫວ້າ	ບ້ານ ຫ້ວຍຄໍ້	ບ້ານ ໜອງແດງ				
ບ້ານ ນາຫວ້າ	ບ້ານ ນາທັງ	ບ້ານ ລະຫາໂຄກ	ບ້ານ ຄືມສະຫວ່າງ				
ບ້ານ ນາຟອງຕີ້ວ	ບ້ານ ພະແລງ	ບ້ານ ນາຍູງ	ບ້ານ ໜອງອີ່ເຫຼືອງ				
ບ້ານ ນາຟອງທ່າ	ບ້ານ ດອນມ່ວງ	ບ້ານ ນາປົ່ງ	ບ້ານ ນາຄູ				
ບ້ານ ນາໜອງຜື	ບ້ານ ດອນຂຽວ	ບ້ານ ໜອງວັດ	 				
ລະຫັດໄປສະນີ ເຂດ 3: 13062				
ບ້ານ ແກ້ງຫີນແກ້ວ	ບ້ານ ທ່າປະຊຸມ	ບ້ານ ຫົວຫາດ	ບ້ານ ຄືມມ່ວນ				
ບ້ານ ໜອງເມັກ	ບ້ານ ນາໂພ	ບ້ານ ໂນນຄຳສູງ	ບ້ານ ເປືອຍຂາວ				
ບ້ານ ຊະບູໄຊ	ບ້ານ ລາດນາດີ	ບ້ານ ສາລາລ້ຽວ	ບ້ານ ຜັກຂະ				
ບ້ານ ທ່າເດື່ອ	ບ້ານ ແກ້ງໂດນ	ບ້ານ ໜອງຄັນຄູ	ບ້ານ ຫ້ວຍໄຂ່				
ບ້ານ ໜອງເດີ່ນທ່າ	ບ້ານ ໂນນສະຫວ່າງ	ບ້ານ ຫີນແຕກ	 				
ລະຫັດໄປສະນີ ເຂດ 4: 13063				
ບ້ານ ນາກະຫຼຶງ	ບ້ານ ນາດົງ	ບ້ານ ນາແສນເທບ	ບ້ານ ໜອງຂອນ				
ບ້ານ ສອງຄອນ	ບ້ານ ນາໂຄ	ບ້ານ ເຊບັ້ງຫຽງ	ບ້ານ ໂຄກກ່ອງ				
ບ້ານ ດົງສະຫວ່າງ	ບ້ານ ໂນນສຳລານ	ບ້ານ ແກ້ງຕາງານ	ບ້ານ ຫີນຄອກ				
ບ້ານ ວິໄຊສົງ	ບ້ານ ນາລາມ	ບ້ານ ໂນນເຕົາຖ່ານ	ບ້ານ ນາອຸດົມ				
ບ້ານ ກຸດຮີ	ບ້ານ ຫີນກອງ	ບ້ານ ໝີຢ້ຽມ	 				
ລະຫັດໄປສະນີ ເຂດ 5: 13064				
ບ້ານ ເຊບັ້ງນວນ	ບ້ານ ນາຮັງແຂ້	ບ້ານ ນາຊະໂນ	ບ້ານ ແບ່ງຄຳໄຫຼ				
ບ້ານ ດອນຫວາຍ	ບ້ານ ດອນຊາດ	ບ້ານ ໜອງເດີ່ນທົ່ງ	ບ້ານ ມ່ວງໄຂ່				
ບ້ານ ນາຄະຍອມ	ບ້ານ ດອນໃຫຍ່	ບ້ານ ສິງທ່າ	 				
ບ້ານ ຄຳສະຫວ່າງ	ບ້ານ ຫຼັກ 11	ບ້ານ ລະຫານ້ຳ	 				
ບ້ານ ດ່ານແຕ້	ບ້ານ ຊະແຍກ	ບ້ານ ທ່າຂາມລຽນ	 				
ເມືອງ ວິລະບູລີ ລະຫັດໄປສະນີ 13070 - 13074				
ລະຫັດໄປສະນີ ເຂດ 1: 13070				
ບ້ານ ນາຍົມ	ບ້ານ ຜາລະພາງ	ບ້ານ ນາຊູ	ບ້ານ ຂີ່ຄັ່ງ				
ບ້ານ ໂຄກ	ບ້ານ ໄຮ່ດົງ	ບ້ານ ເລົາຫຼວງ	ບ້ານ ໜອງກະປາງ				
ບ້ານ ນາບອນ	ບ້ານ ທາດ	ບ້ານ ນ້ອຍ	ບ້ານ ນາມົນ				
ບ້ານ ນາແອະ	ບ້ານ ນາເຕີ້	ບ້ານ ນາພັກພວກ	ບ້ານ ປ່າຜັກເນົາ				
ລະຫັດໄປສະນີ ເຂດ 2: 13071				
ບ້ານ ນາສະເລາະ	ບ້ານ ນາກະຈັບ	ບ້ານ ນ້ຳຄີບ	ບ້ານ ເມືອງແສນ				
ບ້ານ ດົງຕ້ອງ	ບ້ານ ຂົວງະ	ບ້ານ ສົບກົງ	ບ້ານ ນາຊຽງແລ				
ບ້ານ ທ່າ	ບ້ານ ນາແກ	ບ້ານ ນາແທ່ນເຫ່ຍ	ບ້ານ ໂນນສົມພູ				
ບ້ານ ນ້ຳສ້າງ	ບ້ານ ໂນນສົມບູນ	ບ້ານ ກົກຕ້ອງ	ບ້ານ ນ້ຳຄຶບ				
ລະຫັດໄປສະນີ ເຂດ 3: 13072				
ບ້ານ ໃໝ່ນຳແມງ	ບ້ານ ນາມະລູ	ບ້ານ ນາພິລາງ	ບ້ານ ກະຕົບ				
ບ້ານ ນາໂພ	ບ້ານ ປຸງປໍ	ບ້ານ ສົມສະໜຸກ	ບ້ານ ໂນນສຳລານ				
ບ້ານ ດົງຢາງ	ບ້ານ ນ້ຳແລບ	ບ້ານ ນາກະພັງ	ບ້ານ ຜົນຂະເຫຍາະ				
ບ້ານ ນາຂາງ	ບ້ານ ໂນນສະຫວ່າງ	ບ້ານ ໂພນງາມ	ບ້ານ ຫິນແຮ່				
ລະຫັດໄປສະນີ ເຂດ 4: 13073				
ບ້ານທາງແບ່ງແກ້ງຫຼວງ	ບ້ານ ແກ້ງເຫຼັກໃຕ້	ບ້ານ ນ້ຳປາ	ບ້ານ ສະເລາະປາກອຍ				
ບ້ານ ວັງຍາງ	ບ້ານ ສົບປາ	ບ້ານ ອ່າງຄຳ	ບ້ານ ກະລ້າຍ				
ບ້ານ ບຸ່ງຄຳ	ບ້ານ ນ້ຳຈະໂຫຼະ	ບ້ານ ວັນມະເຮັງ	ບ້ານ ຫ້ວຍສູງ				
ບ້ານ ຫ້ວຍຊ້ວນ	ບ້ານ ນ້ຳມະຮີ	ບ້ານ ສົບສະລຸງ	ບ້ານ ຕະລີອາປອບ				
ລະຫັດໄປສະນີ ເຂດ 5: 13074				
ບ້ານ ນາກອຍ	ບ້ານ ເມືອງຫຼວງ	ບ້ານ ນ້ຳປາເຄນ	ບ້ານ ກົກໝາກ				
ບ້ານ ວັງທ່າຄວາຍ	ບ້ານ ຫ້ວຍຫອງ	ບ້ານ ໜອງກະແດ້ງ	ບ້ານ ຫ້ວຍດ່າງ				
ບ້ານ ແກ້ງເກິກ	ບ້ານ ທົ່ງຫຼວງ	ບ້ານ ປ່າດົງ	 				
ບ້ານ ນາກະຊິບ	ບ້ານ ແກ້ງເຫຼັກເໜືອ	ບ້ານ ຕໍເຮືອ	 				
ເມືອງ ທ່າປາງທອງ ລະຫັດໄປສະນີ 13080 - 13083				
ລະຫັດໄປສະນີ ເຂດ 1: 13080				
ບ້ານ ໂນນຈານ	ບ້ານ ນາຫ້ວຍໄລ	ບ້ານ ຫົວຄວາຍ	ບ້ານ ກຸດຮີ				
ບ້ານ ທ່າສາລາຄຳ	ບ້ານ ແກ້ງປີງ	ບ້ານ ໜອງກັນ	ບ້ານ ບຸດຕະພານ				
ບ້ານ ດົງນ້ອຍ	ບ້ານ ນາສະໂນ	ບ້ານ ແກ້ງແກບ	ບ້ານ ໃໜ່ໂພສີ				
ບ້ານ ນາເຊືອກ	ບ້ານ ພູແສງຄຳ	ບ້ານ ຫ້ວຍໜື່ນ	ບ້ານ ທົ່ງປາງ				
ລະຫັດໄປສະນີ ເຂດ 2: 13081				
ບ້ານ ແກ້ງພູມະລີ	ບ້ານ ເຊກື	ບ້ານ ດອນຂາວ	ບ້ານ ແກ້ງສັງກູ				
ບ້ານ ນາປະຊາດ	ບ້ານ ອາຫໍ	ບ້ານ ນາຕັງ	ບ້ານ ນາທະນາມ				
ບ້ານ ພູຜານາງ	ບ້ານ ໄຊສົມບູນ	ບ້ານ ນາຖຳໜູ	ບ້ານ ທ່າພີ				
ບ້ານ ນາເລົາ	ບ້ານ ແດນສະຕິງ	ບ້ານ ພະນຽດ	ບ້ານ ຫີນຕັ້ງໂຄກ				
ລະຫັດໄປສະນີ ເຂດ 3: 13082				
ບ້ານ ຜືວຽງຄຳ	ບ້ານ ລະວາງໃຫຍ່	ບ້ານ ຫີນຕັ້ງກາງ	ບ້ານ ດົງອາລາງ				
ບ້ານ ໂນນສະຫວ່າງ	ບ້ານ ເຊປອງ	ບ້ານ ນາຈັນທາງ	ບ້ານ ບົ່ງເຊທະມວກ				
ບ້ານ ບາກຂຸມຄຳ	ບ້ານ ປະດອງ	ບ້ານ ແກ້ງຫຼີ່	ບ້ານ ນາໄຊ				
ບ້ານ ໂນນສີວິໄລ	ບ້ານ ຫ້ວຍໄລ່-ນາພວງ	ບ້ານ ປົ່ງ	ບ້ານ ນາສະໂນ				
ລະຫັດໄປສະນີ ເຂດ 4: 13083				
ບ້ານ ນາລະແອນ	ບ້ານ ນາທອງ	ບ້ານ ໜອງແຂ້	ບ້ານ ໜອງສິມ				
ບ້ານ ລຳທວນ	ບ້ານ ຕັ້ງຫວາຍໂຄກ	ບ້ານ ນາຈານໃຫຍ່	ບ້ານ ດົງໜອງແຄນ				
ບ້ານ ດົງມົດ	ບ້ານ ລຳບຽດ	ບ້ານ ກະທອງເຊ	ບ້ານ ເມືອງໂຮງ				
ບ້ານ ປະລຸງ	ບ້ານ ສະໜາມໄຊ	ບ້ານ ຕັ້ງຫວາຍນ້ຳ	 				
ເມືອງ ຊົນນະບູລີ ລະຫັດໄປສະນີ 13090 - 13093				
ລະຫັດໄປສະນີ ເຂດ 1: 13090				
ບ້ານ ກອງປະທຸມວັດ	ບ້ານ ໜອງຜຳ	ບ້ານ ໂນນຄູ້	ບ້ານ ຫົງຄຳ				
ບ້ານ ໂນນສະຫວ່າງ	ບ້ານ ນາຫົວຫຼວງ	ບ້ານ ບຶງຊ້າງ	ບ້ານ ດົງນາຄຳ				
ບ້ານ ຊຽງຮົ່ມ	ບ້ານ ດົງບູນ	ບ້ານ ໂຄກຫົວຊ້າງ	ບ້ານ ໜອງບົວຫຼວງ				
ບ້ານ ທ່າຂາມເຫຼືອມ	ບ້ານ ຕົ່ມແຍ	ບ້ານ ດົງຫວາຍ	ບ້ານ ໂພນຕານ				
ລະຫັດໄປສະນີ ເຂດ 2: 13091				
ບ້ານ ນາໂພນທອງ	ບ້ານ ແສງຈະເລີນ	ບ້ານ ແກ້ວຄຳດີ	ບ້ານ ນາບົງ				
ບ້ານ ດອນຍາໂນງ	ບ້ານ ໂພໄຊຄູນ	ບ້ານ ໜອງສອງຫ້ອງ	ບ້ານ ໜອງເບັນ				
ບ້ານ ໂນນຍາງ	ບ້ານ ໄຊສົມບູນ	ບ້ານ ກະເບົາ	ບ້ານ ໂນຮັ່ງມີ				
ບ້ານ ໜອງຜື	ບ້ານ ດວງມາລາ	ບ້ານ ຫົວຄວາຍ	ບ້ານ ນາຫວ້າສົມໄຊ				
ລະຫັດໄປສະນີ ເຂດ 3: 13092				
ບ້ານ ອາຫໍ	ບ້ານ ໜອງບົວລາວ	ບ້ານ ໄຊວົງທິລາດ	ບ້ານ ດົງອາລາງ				
ບ້ານ ວິໄຊ	ບ້ານ ຕຳປອງ	ບ້ານ ອາລາງ	ບ້ານ ບົ່ງເຊທະມວກ				
ບ້ານ ນາແພງ	ບ້ານ ປະຕົງ	ບ້ານ ແກ້ງຫຼີ່	ບ້ານ ນາໄຊ				
ບ້ານ ອຳພາວັງ	ບ້ານ ເຊວັນ	ບ້ານ ປົ່ງ	ບ້ານ ນາສະໂນ				
ລະຫັດໄປສະນີ ເຂດ 4: 13093				
ບ້ານ ນາລະແອນ	ບ້ານ ນາທອງ	ບ້ານ ໜອງແຂ້	ບ້ານ ໜອງສິມ				
ບ້ານ ລຳທວນ	ບ້ານ ຕັ້ງຫ້ວຍໂຄກ	ບ້ານ ນາຈານໃຫຍ່	ບ້ານ ດົງໜອງແຄນ				
ບ້ານ ດົງມົດ	ບ້ານ ລຳບຽດ	ບ້ານ ກະທອງເຊ	ບ້ານ ເມືອງໂຮງ				
ບ້ານ ປະລຸງ	ບ້ານ ສະໜາມໄຊ	ບ້ານ ຕັ້ງຫວາຍນ້ຳ	 				
ເມືອງ ໄຊບູລີ ລະຫັດໄປສະນີ 13100 - 13102				
ລະຫັດໄປສະນີ ເຂດ 1: 13100				
ບ້ານໝາກນາວໃຕ້	ບ້ານ ສະກອງ	ບ້ານ ຍາງຄ້ຳ	ບ້ານ ໝາກນາວ				
ບ້ານ ຫ້ວຍແຫ່	ບ້ານ ຜັກເຜື້ອ	ບ້ານ ເລົ່າຜ້າຍ	ບ້ານ ເຄືອເຂົາກາດ				
ບ້ານ ໜອງເຮືອທອງ	ບ້ານ ສົມສະອາດ	ບ້ານ ແກ້ງແຮດ	ບ້ານ ປາກເຊບັ້ງໄຟ				
ບ້ານ ແກ້ງໂພສີ	ບ້ານ ດົງພ້າວ	ບ້ານ ດົງຍາງ	 				
ບ້ານ ກ້າງປາ	ບ້ານ ງາສອນ	ບ້ານ ດົງພູ້	 				
ລະຫັດໄປສະນີ ເຂດ 2: 13101				
ບ້ານບົວໄຂ	ບ້ານ ແກ້ງກະເບົາໃຕ້	ບ້ານ ສະຫວ່າງ	ບ້ານ ຊຽງໃຄ				
ບ້ານ ນາສັງ	ບ້ານ ສີວິໄລ	ບ້ານ ນາເທິງ	ບ້ານ ແກ້ງແວງ				
ບ້ານ ທ່າຂາມ	ບ້ານ ຄຳໂນນສູງ	ບ້ານ ຜັກຂະຍ່າ	ບ້ານ ດົງໝາກໄຟ				
ບ້ານ ທ່າຄໍ້	ບ້ານ ດົງພຸງ	ບ້ານ ໜອງແວງ	 				
ບ້ານແກ້ງກະເບົາເໜືອ	ບ້ານ ໜອງສະພັງ	ບ້ານ ພູໂກະ	 				
ລະຫັດໄປສະນີ ເຂດ 3: 13102				
ບ້ານປ່າໄຫຼ	ບ້ານ ນາແດງ	ບ້ານ ບຶງເຊ	ບ້ານ ດ້າງສະຫວັນ				
ບ້ານ ນາມ່ວງ	ບ້ານ ດົງໄປວັນ	ບ້ານ ຕົ້ນແຫນ	ບ້ານ ສີໄຄ				
ບ້ານ ກະຈຸ	ບ້ານ ນາເຮືອງ	ບ້ານ ເວີນເໜືອ	 				
ບ້ານ ມະນີລາດ	ບ້ານ ໜອງຂຽດເຫຼືອງ	ບ້ານ ເວີນໃຕ້	 				
ບ້ານ ກາງ	ບ້ານ ຫາດຊາຍສູງ	ບ້ານ ໂພນທັນ	 				
ເມືອງ ອາດສະພອນ ລະຫັດໄປສະນີ 13110 - 13113				
ລະຫັດໄປສະນີ ເຂດ 1: 13110				
ບ້ານທາດດອກແກ້ວ	ບ້ານ ນາຮັງນ້ອຍ	ບ້ານ ດົງຫວາຍດິນ	ບ້ານ ນາເຂົ້າໝິ້ນ				
ບ້ານ ນາກຸດຈານ	ບ້ານ ກຸດແຄນ	ບ້ານ ນາທົມ	ບ້ານ ຫິນສີ່ວ				
ບ້ານ ຜັກຂະຫຍ່າ	ບ້ານ ສອງຫ້ອງ	ບ້ານ ດົງທະດາ	 				
ບ້ານ ໜອງເດີ່ນ	ບ້ານ ວັງມົນ	ບ້ານ ນາເດື່ອ	 				
ລະຫັດໄປສະນີ ເຂດ 2: 13111				
ບ້ານນາໝາກເກືອ	ບ້ານ ກົກແດງ	ບ້ານ ບຶງ	ບ້ານ ໂພນແພງ				
ບ້ານ ກຸດຊຸງ	ບ້ານ ໂພນນາດີ	ບ້ານ ໂພນງາມ	ບ້ານ ຜັກກະດາ				
ບ້ານ ສົ້ມໂຮງ	ບ້ານ ໂພນຕູມ	ບ້ານ ກະທິງໄກ່	ບ້ານ ນາແຄ				
ບ້ານ ດອນກອງ	ບ້ານ ໂພໄຊ	 	 				
ລະຫັດໄປສະນີ ເຂດ 3: 13112				
ບ້ານໂນນຍາງ	ບ້ານ ກາງທ່າ	ບ້ານ ຫ້ວຍຍາງ	ບ້ານ ໂພນບົກ				
ບ້ານ ນານ້ອຍ	ບ້ານ ດົງຄຳກວານ	ບ້ານ ແກ້ງແມວ	ບ້ານ ສົບເຊ				
ບ້ານ ບັງເບດເຊ	ບ້ານ ໂຄກກະຕ່າຍ	ບ້ານ ແກ້ງມົນ	ບ້ານ ນາປອດ				
ບ້ານ ຄຳພູ	ບ້ານ ແກ້ງແດງ	 	 				
ລະຫັດໄປສະນີ ເຂດ 4: 13113				
ບ້ານກຸດຫີນ	ບ້ານ ວຽງໄຊ	ບ້ານ ນາກະປົງ	ບ້ານ ດົງຂັນຄຳ				
ບ້ານ ໄຊໂພນສິມ	ບ້ານ ຈອມຮາດ	ບ້ານ ນາເລົ່າ	ບ້ານ ຫ້ວຍງົວຄຳ				
ບ້ານ ຕົ້ນໂພສີ	ບ້ານ ນາຍອນ	ບ້ານ ຫ້ວຍເດື່ອ	 				
ບ້ານ ບຶງພະເນົາ	ບ້ານ ນາຂາມ	ບ້ານ ສິງສະຫວ່າງ	 				
ເມືອງ ໄຊພູທອງ ລະຫັດໄປສະນີ 13120 - 13122				
ລະຫັດໄປສະນີ ເຂດ 1: 13120				
ບ້ານທ່າດ່ານ	ບ້ານ ບຸ່ງນາດີ	ບ້ານ ສົມສະອາດ	ບ້ານ ໂພນສົ້ມໂຮງ				
ບ້ານ ນາພານ	ບ້ານ ຫົວຫາດ	ບ້ານ ພູມມະເຈດີ	ບ້ານ ໂພນທາດ				
ບ້ານ ດອນຫວາຍ	ບ້ານ ທ່າໂພ	ບ້ານ ນາໝາກເກືອ	ບ້ານ ມ່ວງໄຂ່				
ບ້ານ ຄັນທະຈານ	 	 	 				
ລະຫັດໄປສະນີ ເຂດ 2: 13121				
ບ້ານດອນຕູມ	ບ້ານ ນາໂດນ	ບ້ານ ຄຳຊັນ	ບ້ານ ນາລະໂອງ				
ບ້ານ ສີສະຫວ່າງເໜືອ	ບ້ານ ດົງໂພສີ	ບ້ານ ນາຄຳ	ບ້ານ ໂພສີແກ້ວ				
ບ້ານ ດົງໝາກໄພ	ບ້ານ ຂົດດຳ	ບ້ານ ຕາກແດດ	ບ້ານ ຄຳແສນໄຊ				
ບ້ານ ນ້ຳຜຸ	 	 	 				
ລະຫັດໄປສະນີ ເຂດ 3: 13122				
ບ້ານໂພນທັນ	ບ້ານ ນາດູ່	ບ້ານ ເຮືອນຫີນ	ບ້ານ ຫ້ວຍຂະຫຍອງ				
ບ້ານ ຫ້ວຍມ່ວງ	ບ້ານ ນາຈານ	ບ້ານ ເຫຼົ່າໝາກຫູດ	ບ້ານ ດອນສະໂນດ				
ບ້ານ ສີວິໄລ	ບ້ານ ສີສະຫວ່າງໃຕ້	ບ້ານ ດົງດອກໄມ້	ບ້ານ ເວີນຄູນ				
ບ້ານ ນາບໍ່	 	 	 				
ເມືອງ ພະລານໄຊ ລະຫັດໄປສະນີ 13130 - 13132				
ລະຫັດໄປສະນີ ເຂດ 1: 13130				
ບ້ານພະລານໄຕ້	ບ້ານ ນາໂພວັດ	ບ້ານ ຫົວເມືອງ	ບ້ານ ແກ້ງຊາຍນ້ອຍ				
ບ້ານ ພະລານເໜືອ	ບ້ານ ກາງທົ່ງ	ບ້ານ ບຶງທະເລ	ບ້ານ ນາຂວາງ				
ບ້ານ ນາໝາກມີ້	ບ້ານ ນາໂພສົມບູນ	ບ້ານ ກະທ໋ອງເໜືອ	ບ້ານ ນາຮູ				
ບ້ານ ພະນົມໄຊ	ບ້ານ ໂພນຕານ	ບ້ານ ກະທ໋ອງໄຕ້	 				
ບ້ານ ໂພໄຊ	ບ້ານ ໜອງແວງ	ບ້ານ ນາກາງເຊ	 				
ລະຫັດໄປສະນີ ເຂດ 2: 13131				
ບ້ານແກ້ງພາມ	ບ້ານ ສົມອູ່	ບ້ານ ນາສະຄຸ	ບ້ານ ກະແສນ				
ບ້ານ ຊ່າງແສງ	ບ້ານ ນາທ່ອນ	ບ້ານ ນາທູ້ໃຫຍ່	ບ້ານ ນາມ່ວງ				
ບ້ານ ອຸດົມໄຊ	ບ້ານ ນາຈັນໄຕ	ບ້ານ ໂພນ	ບ້ານ ຊຽງແລນ້ຳ				
ບ້ານ ຄຳເຕີຍ	ບ້ານ ນາຂັ້ນໄດ	ບ້ານ ກະສົກຄຳ	 				
ບ້ານ ແກ້ງຫຼວງ	ບ້ານ ນາຫີນແຕກ	ບ້ານ ໂພນບົກ	 				
ລະຫັດໄປສະນີ ເຂດ 3: 13132				
ບ້ານດ່ວນ	ບ້ານ ນາລາຍ	ບ້ານ ສະໜູນ	ບ້ານ ດອນຕິ້ວ				
ບ້ານ ໜອງຜື	ບ້ານ ນາບໍຄຳ	ບ້ານ ໂນມີໄຊ	ບ້ານ ແກ້ງໄຊໃຫຍ່				
ບ້ານ ແກ້ງຈິບ	ບ້ານ ນາກະປົງ	ບ້ານ ດົງບັງ	 				
ບ້ານ ເທີ້ມໃຫຍ່	ບ້ານ ຊຽງແລໂຄກ	ບ້ານ ໂທະ	 				
ບ້ານ ເທີ້ມນ້ອຍ	ບ້ານ ໂພສີ	ບ້ານ ນາຊາຍ	 				









ແຂວງ ສາລະວັນ
ເລກລະຫັດໄປສະນີ 14000
ແຂວງ ສາລະວັນ 14xxx
ເມືອງ ສາລະວັນ ລະຫັດໄປສະນີ 14000 - 14009
ລະຫັດໄປສະນີ ເຂດ 1: 14000  
ບ້ານ ນາເຫຼັກ	ບ້ານ ໜອງສະເກີງ	ບ້ານ ນາໂຄກ	ບ້ານ ທ່າເມືອງເກົ່າ
ບ້ານ ວັດກາງ	ບ້ານ ຄັນຈົມ	ບ້ານ ໂພນຕານ	ບ້ານ ນາແພງ
ບ້ານ ໂພນແກ້ວ	ບ້ານ ຄັນທະລາດ	ບ້ານ ໂພນບົກ	ບ້ານ ເສົາກະດີ
ບ້ານ ນາກົກໂພ	ບ້ານ ນາໂດນ	ບ້ານ ເຕົ່າປູນ	ບ້ານ ທ່າເມືອງເຊ
ບ້ານ ຫຼັກ II	ບ້ານ ໂພໄຜ່	ບ້ານ ແສນວັງ	 
ບ້ານ ຫາດທອງຫຼວງ	ບ້ານ ນາທ່ອນ	ບ້ານ ນາດອນຂວາງ	 
ລະຫັດໄປສະນີ ເຂດ 2: 14001 
ບ້ານ ນາທູນ	ບ້ານ ນາພະຍີ່	ບ້ານ ນາທູນນ້ອຍ	ບ້ານ ຫາງພູນ້ອຍ
ບ້ານ ທາດນ້ອຍ	ບ້ານ ນາທົ່ງຫຼວງ	ບ້ານ ດົງໜ້ອງ	 
ບ້ານ ທາດຫ້ວຍ	ບ້ານ ນາຂ້ອຍສາວ	ບ້ານ ນາລາດ	 
ລະຫັດໄປສະນີ ເຂດ 3: 14002 
ບ້ານ ນາທານກ້ວຍ	ບ້ານ ສູງ	ບ້ານ ວຽງຄຳ	ບ້ານ ທົ່ງປາປົກ
ບ້ານ ໂກະ	ບ້ານ ພ້າວ	ບ້ານ ຫາງພູໃຫຍ່	ບ້ານ ດົງສະວັງ
ລະຫັດໄປສະນີ ເຂດ 4: 14003
ບ້ານ ນາໄຊໃຫຍ່	ບ້ານ ສະໂປນ	ບ້ານ ປາກແລັງ	ບ້ານ ຈານເໜືອ
ບ້ານ ໜອງສະໂນ	ບ້ານ ດອນຂາວ	ບ້ານ ສອງກະລອງ	 
ບ້ານ ນາໄຊນ້ອຍ	ບ້ານ ເລີນສຳພັນ	ບ້ານ ແກງກະເວົາ	 
ລະຫັດໄປສະນີ ເຂດ 5: 14004
ບ້ານດົງໂກະ	ບ້ານ ກະດັບ	ບ້ານ ນາເຕິ	ບ້ານ ສຸຕຸວະລີ
ບ້ານ ແບ່ງອຸດົມ	ບ້ານ ລະວາງ	ບ້ານ ຫ້ວຍລະນົງ	ບ້ານ ນາຕຶມ
ບ້ານ ຄຽງໂຄ້ງ	ບ້ານ ແສງວັງນ້ອຍ	ບ້ານ ນາຕູ	ບ້ານ ແລງໃໝ່
ລະຫັດໄປສະນີ ເຂດ 6: 14005 
ບ້ານ ທົ່ງນາຄຳ	ບ້ານ ຈານໃຕ້	ບ້ານ ພະນວນ	ບ້ານ ນາດອນບົງ
ບ້ານ ໜອງໃສ	ບ້ານ ນາໄຊສ່ວຍ	ບ້ານ ໜອງບົວນ້ອຍ	ບ້ານ ຫ້ວຍດາດ
ບ້ານ ບຶງຂາມ			 
ລະຫັດໄປສະນີ ເຂດ 7: 14006 
ບ້ານ ຈານວົງ	ບ້ານ ຕົ້ງສີວິໄລ	ບ້ານ ແກ້ງເປາະ	ບ້ານ ໝອງໝໍ້
ບ້ານ ຜັກແພວເສັດ	ບ້ານ ຜັກແພວທົ່ງ	ບ້ານ ນາຫີນໂລງ	ບ້ານ ບຶງໄຊ
ບ້ານ ວັງງົວ	ບ້ານ ຕົ້ງໃຫຍ່	ບ້ານ ໂຄກສະຫວາດ	 
ບ້ານ ໜອງຫີນບູ	ບ້ານ ແກ້ງຂຸມ	ບ້ານ ນາໂພເລີນ	 
ລະຫັດໄປສະນີ ເຂດ 8: 14007
ບ້ານແກ້ງສິມ	ບ້ານ ນາຫວ້າ	ບ້ານ ດ່ານໃຫຍ່	ບ້ານ ເລີນປະອູບ
ບ້ານ ນາບອນ	ບ້ານ ຄັນໝາກໂຍດ	ບ້ານ ຄັນງົວ	ບ້ານ ໜອງຄ້າ
ບ້ານ ໂນນສະຫວັນ	 	 	 
ລະຫັດໄປສະນີ ເຂດ 9: 14008
ບ້ານ ກະຊະໃຫຍ່	ບ້ານ ໜອງໝາກຍາງ	ບ້ານ ຄຳທອງ	ບ້ານ ນາຄູ
ບ້ານ ສອງຄອນ	ບ້ານ ແກ້ງເມືອງລາວ	ບ້ານ ຕົ້ງຊວຍ	ບ້ານ ໜອງຜັ່ງຍອງ
ບ້ານ ກະຊະນ້ອຍ	ບ້ານ ປາກປົ່ງ	ບ້ານ ໜອງເພັກ	ບ້ານ ໜອງເຜິ້ງ
ລະຫັດໄປສະນີ ເຂດ 10: 14009
ບ້ານ ທົ່ງປິວ	ບ້ານ ນາປາລີ	ບ້ານ ໂພນທັນ	ບ້ານ ຫາດເກາະນ້ຳ
ບ້ານ ໂຄກເກົ່າ	ບ້ານ ຜັກຂະໃຫຍ່	ບ້ານ ໜອງບົວໃຫຍ່	ບ້ານ ນາໂພນ້ອຍ
ບ້ານ ໂຄກໃໝ່	ບ້ານ ໝາກນາວນ້ອຍ	ບ້ານ ແບ່ງວັງຈັນ	ບ້ານ ນາໂພໃຫຍ່
ບ້ານ ປາກປຸຍ	ບ້ານ ໝາກນາວໃຫຍ່	ບ້ານ ກະທ້າງ	 
ບ້ານ ວັງຊອນ	ບ້ານ ບຸ່ງສຸ້ຍ	ບ້ານ ບ່ວງໃຫຍ່	 
ເມືອງ ຕະໂອ້ຍ ລະຫັດໄປສະນີ 14010 - 14014
ລະຫັດໄປສະນີ ເຂດ 1: 14010
ບ້ານ ເທດສະບານ	ບ້ານ ລະວຽງ	ບ້ານ ກັງ	ບ້ານ ຕຸ່ມລິເກົ່າ
ບ້ານ ຕະຫຼຸງລະລາວ	ບ້ານ ແຕນ	ບ້ານ ຫຸນ	ບ້ານ ຕຸ່ມລີຂາວ
ບ້ານ ຮູກະໂຍ	ບ້ານ ຊືງຕະມອງ	ບ້ານ ປະສິງ	 
ບ້ານ ລະແຊງ	ບ້ານ ລະປືງ	ບ້ານ ຕຸ່ມລິທົ່ງ	 
ລະຫັດໄປສະນີ ເຂດ 2: 14011
ບ້ານ ປຼອຍ	ບ້ານ ປະດຸ	ບ້ານ ສ້ອຍທົ່ງ	ບ້ານ ສ້ອຍຕາມ
ບ້ານ ກົກບົກ	ບ້ານ ຫ້ວຍງົວ	ບ້ານ ກະໂອນເກົ່າ	ບ້ານ ຕະປືນພູ
ບ້ານ ປະຈຸກະປາ			 
ລະຫັດໄປສະນີ ເຂດ 3: 14012
ບ້ານ ສັນຍາຍອນ	ບ້ານ ທົ່ງກາໄຮ່	ບ້ານ ທົ່ງຊະ	ບ້ານ ໂບງນ້ຳ
ບ້ານ ດຶກດົງ	ບ້ານ ກະມ່ວນ	ບ້ານ ປິຕຽນ	ບ້ານ ສະບອງກົກໄຮ
ບ້ານ ທົ່ງກາໄຕ້	ບ້ານ ປະໂສມ		 
ລະຫັດໄປສະນີ ເຂດ 4: 14013
ບ້ານ ກະແປ	ບ້ານ ດູບ	ບ້ານ ປະງານດາວ	ບ້ານ ພໍເບີຍ
ບ້ານ ກະເຕັນ	ບ້ານ ພໍຕັງ	ບ້ານ ປະງານສິງ	 
ບ້ານ ປະເຕມ	ບ້ານ ພໍເຊັນ	ບ້ານ ສະແໜງ	 
ລະຫັດໄປສະນີ ເຂດ 5: 14014
ບ້ານ ລະຫາບ	ບ້ານ ໂຈະໃຕ້	ບ້ານ ຕຸງໂກງ	ບ້ານ ຕຸງແຕງ
ບ້ານ ປະເສັຍ	ບ້ານ ຕະຮວກ	ບ້ານ ປີໂກະ	ບ້ານ ອາງໍ
ບ້ານ ປະຈູດອນ	ບ້ານ ໂຈະໄຮ່	ບ້ານ ອາດອນ	ບ້ານ ອາດື
ບ້ານ ປະຈູເຈີນ	 	 	 
ເມືອງ ຕຸ້ມລານ ລະຫັດໄປສະນີ 14020 - 14023 
ລະຫັດໄປສະນີ ເຂດ 1: 14020
ບ້ານ ສາມັກຄີໄຊ	ບ້ານ ນາຮ່ອງໃຫຍ່	ບ້ານ ຕຸກລຸກ	ບ້ານ ດິນດາກ
ບ້ານ ຫ້ວຍຫວ້າ	ບ້ານ ວັງໂກ້ຍ	ບ້ານ ຕະແບງ	 
ບ້ານ ໂພນງາມ	ບ້ານ ດອນບຸ່ງ	ບ້ານ ແກ້ງຮັງ	 
ລະຫັດໄປສະນີ ເຂດ 2: 14021
ບ້ານ ກະແໝບ	ບ້ານ ສະໂນ	ບ້ານ ນາຮ່ອງນ້ອຍ	ບ້ານ ຕະເຢີກ
ບ້ານ ກົກມ່ວງ	ບ້ານ ຕະນົວ	ບ້ານ ລະມຶກ	ບ້ານ ວັງລີ
ລະຫັດໄປສະນີ ເຂດ 3: 14022
ບ້ານ ຕະເວີຍ	ບ້ານ ວັງເຮືອ	ບ້ານ ນາດູ່	ບ້ານ ດອນຊາດ
ບ້ານ ຕ່ຳແບ່ງ	ບ້ານ ບອຍນ້ຳ	ບ້ານ ຖ້ຳມະລຶ	ບ້ານ ນາໂພໃຫຍ່
ບ້ານ ອາເປ້ຍ			 
ລະຫັດໄປສະນີ ເຂດ 4: 14023
ບ້ານ ຫ້ວຍໄລ່	ບ້ານ ຕຸ້ມລານ	ບ້ານ ດອນຂະຍຸງ	ບ້ານ ນາມະຕອງ
ບ້ານ ກະຕາວ	ບ້ານ ນາກະເຈີມ	ບ້ານ ດອນມ່ວງ	ບ້ານ ທົ່ງໄກ່ຂວາ
ບ້ານ ນາລະຈາງ			 
ເມືອງ ສະໝ້ວຍ ລະຫັດໄປສະນີ 14030 - 14033 
ລະຫັດໄປສະນີ ເຂດ 1: 14030
ບ້ານ ເທດສະບານ	ບ້ານ ອາຈຶແລັງ	ບ້ານ ອາຊິງໄຕ	ບ້ານ ອາຊິງເໜືອ
ບ້ານ ອາຈຶລິແລ	ບ້ານ ແມວ	ບ້ານ ລະວາໄຕ້	 
ລະຫັດໄປສະນີ ເຂດ 2: 14031
ບ້ານ ອາແດງກູຕາ	ບ້ານ ລະໄລສ້ອຍ	ບ້ານ ລະວາເໜືອ	ບ້ານ ພີນເຊ
ບ້ານ ອາຕຸກ	ບ້ານ ລະຮາງ	ບ້ານ ປັນໄຕ	ບ້ານ ຕັນດີ
ບ້ານ ລະໄລກົງ	ບ້ານ ຕັງໂກ	ບ້ານ ພີນເບ	ບ້ານ ອາວາວ
ບ້ານ ລະເລາະ	ບ້ານ ພີນອາ	ບ້ານ ອາເສົາ	 
ລະຫັດໄປສະນີ ເຂດ 3: 14032
ບ້ານ ອາສົກອັນລະ	ບ້ານ ອາເມັນ	ບ້ານ ລະເສນ	ບ້ານ ຕະໂລຍ
ບ້ານ ອັນລະ	ບ້ານ ອາຈາຮຸງຕຸນ	ບ້ານ ສະໝ້ວຍ	ບ້ານ ກິລິໃຫຍ່
ບ້ານ ໂຮ່	ບ້ານ ເຊ	ບ້ານ ກິແນະ	ບ້ານ ຕຶບເໜືອ
ບ້ານ ປະລຸອາຕາງ	ບ້ານ ຕັນຢູ	ບ້ານ ອາວອງ	ບ້ານ ອາໄມ
ບ້ານ ອາເສົາອາຢົງ	ບ້ານ ລະຕົວະ	ບ້ານ ຕະຫຼຸງກາງ	ບ້ານ ຕັງກວນ
ບ້ານ ຕະລຽບ			 
ລະຫັດໄປສະນີ ເຂດ 4: 14033
ບ້ານ ອາໂຫ້	ບ້ານ ປີໄຮ່	ບ້ານ ຕະລໍໄຕ້	ບ້ານ ກູໂບຍ
ບ້ານ ອາວ້າຍ	ບ້ານ ກະເລງ	ບ້ານ ຕະລໍເໜືອ	ບ້ານ ຕະຫວາຍ
ເມືອງ ວາປີ ລະຫັດໄປສະນີ 14040 - 14045
ລະຫັດໄປສະນີ ເຂດ 1: 14040
ບ້ານພູມສະຫວັນ	ບ້ານ ດົງມອນ	ບ້ານ ຈ່ອງ	ບ້ານ ແມດ
ບ້ານ ໜອງໂພ	ບ້ານ ສະເໝັຍ	ບ້ານ ດົງລະອູ	 
ລະຫັດໄປສະນີ ເຂດ 2: 14041
ບ້ານ ນາຊັນ	ບ້ານ ເລົ່າ	ບ້ານ ສະພາດ	ບ້ານ ນາມ່ວງ
ບ້ານ ນາຮ່ອງຂາມ	ບ້ານ ຫາດ	ບ້ານ ນາໂພນຕານ	ບ້ານ ນາຫວ້າ
ບ້ານ ແກ້ງນ້ອຍ	ບ້ານ ແກ້ງສຸທິ	ບ້ານ ນາຫົວແຮດ	ບ້ານ ລານ
ບ້ານ ແກ້ງກຸ	ບ້ານ ມ່ວນເວີນຄຳ	ບ້ານ ນາໂພ	 
ລະຫັດໄປສະນີ ເຂດ 3: 14042
ບ້ານ ຜັກຂະ	ບ້ານ ຫ້ວຍໂຄນ	ບ້ານ ໜອງໂງ້ງ	ບ້ານ ນ້ອຍເຊ
ບ້ານ ບັງຄານ້ຳ	ບ້ານ ຕານສຸມ	ບ້ານ ເກາະຊອງ	ບ້ານ ນາກົກຕານ
ບ້ານ ວາປີ	ບ້ານ ນາລະໂອງ	ບ້ານ ຫີນດ່ານ	 
ລະຫັດໄປສະນີ ເຂດ 4: 14043
ບ້ານ ດອນຂ່າ	ບ້ານ ດອນເໝັ້ນ	ບ້ານ ໜອງບົວ	ບ້ານ ໜອງເຜິ້ງ
ບ້ານ ຄອນສາຍ	ບ້ານ ນາພິມານ	ບ້ານ ນາໜອງຈານ	ບ້ານ ໄຜ່ລ້ອມ
ບ້ານ ນາກາງ	ບ້ານ ກອງລື້ນ້ອຍ	ບ້ານ ນາຊາດ	ບ້ານ ໂນນຄໍ້
ບ້ານ ບັງຄາໂຄກ			 
ລະຫັດໄປສະນີ ເຂດ 5: 14044
ບ້ານ ໂພນແພງ	ບ້ານ ຂະເໝົາ	ບ້ານ ດອນຄຳ	ບ້ານ ທົ່ງຂຽນ
ບ້ານ ສິມ	ບ້ານ ນາສຽດ		 
ລະຫັດໄປສະນີ ເຂດ 6: 14045
ບ້ານ ກອງລື້ໃຫຍ່	ບ້ານ ນາລັນ	ບ້ານ ນາຕະປ່ຽນ	 
 			 
ເມືອງ ຄົງເຊໂດນ ລະຫັດໄປສະນີ 14050 - 14058
ລະຫັດໄປສະນີ ເຂດ 1: 14050
ບ້ານ ຄົງໃຫຍ່	ບ້ານ ນາແພງໃຫຍ່	ບ້ານ ໂນນຄໍ້	ບ້ານ ແກ້ງຕະຫວັງ
ບ້ານ ທົ່ງຈະເລີນ	ບ້ານ ໂຮງເລື່ອຍມີໄຊ	ບ້ານ ບົວລະພາ	ບ້ານ ໜອງສະພັງ
ບ້ານ ຄົງລະຄອນ	ບ້ານ ຄົງນ້ອຍ	ບ້ານ ບຶງກາງ	ບ້ານ ໜອງເກາະຊອງ
ບ້ານ ວັງການຮຸງ			 
ລະຫັດໄປສະນີ ເຂດ 2: 14051
ບ້ານ ໂນນບົກ	ບ້ານ ໜອງໂນ	ບ້ານ ກຸດມີໄຊ	ບ້ານ ດິນກອກ
ບ້ານ ນາໂພ	ບ້ານ ສົມສະອາດ	ບ້ານ ນາປົ່ງ	 
ລະຫັດໄປສະນີ ເຂດ 3: 14052
ບ້ານ ດອນໄຜ່ບ້ານ	ບ້ານ ຄຳຄໍ້	ບ້ານ ຕານປ່ຽວ	ບ້ານ ປາກເຊືອກນາຮັງ
ບ້ານ ຈາລານເຊ	ບ້ານ ນາຄຳ	ບ້ານ ໝື່ນປູ	 
ລະຫັດໄປສະນີ ເຂດ 4: 14053
ບ້ານນາຫວດ	ບ້ານ ໂນນ	ບ້ານ ສະເທີມ	ບ້ານ ຄຳໄຮ
ບ້ານ ຕະຫຼາງ	ບ້ານ ນາເມັກ	ບ້ານ ປົງ	ບ້ານ ໜອງແສງລາວ
ບ້ານ ນາຕານດົງ	ບ້ານ ນາເຕີຍ	ບ້ານ ປັດຊຸມ	ບ້ານ ນາໂຄກ
ບ້ານ ເຫຼົ່າ	 	 	 
ລະຫັດໄປສະນີ ເຂດ 5: 14054
ບ້ານ ຫີນສິ່ວ	ບ້ານ ໜອງບົວ	ບ້ານ ໂອກາດນ້ອຍ	ບ້ານ ບຶງມານ
ບ້ານ ຄຳທອງ	ບ້ານ ໜອງແຕງ	ບ້ານ ຝັງຖານໃຫຍ່	ບ້ານ ໂອກາດໃຫຍ່
ບ້ານ ໂນນສຳລານ	ບ້ານ ເມືອງເກົ່າ	ບ້ານ ຝັງຖານນ້ອຍ	ບ້ານ ຫ້ວຍເຊົາ
ບ້ານ ດອນເມືອງ	ບ້ານ ໜອງຄຸລຸ	 	 
ລະຫັດໄປສະນີ ເຂດ 6: 14055
ບ້ານ ອີເລີງ	ບ້ານ ນາມ່ວງ	ບ້ານ ຄຳອິ	ບ້ານ ຄັນທຸງໄຊ
ບ້ານ ໂຄກຫົວຊ້າງ	ບ້ານ ດອນກ່ອງເຂົ້າ		 
ລະຫັດໄປສະນີ ເຂດ 7: 14056
ບ້ານ ໂຄກຫີນກອງ	ບ້ານ ນາສະດອງ	ບ້ານ ນາໂນງ	ບ້ານ ຄຳຕື້
ບ້ານ ກຸດຫີນ	ບ້ານ ໂນນຫີນຕັ້ງ	ບ້ານ ຊາຍມົນ	ບ້ານ ຊາຍຄຳ
ບ້ານ ນາໂພໄຊ	ບ້ານ ນາກອກ		 
ລະຫັດໄປສະນີ ເຂດ 8: 14057
ບ້ານ ຫາດຊາຍຄຳ	ບ້ານ ຕານດ່ຽວ	ບ້ານ ນາທຶນ	ບ້ານ ນາພູລາວ
ບ້ານ ຫາດດູ່	ບ້ານ ແກ້ງຫວດ	ບ້ານ ມ່ວງຊຸມ	 
ລະຫັດໄປສະນີ ເຂດ 9: 14058
ບ້ານ ແກ້ງໂຄນ	ບ້ານ ໜອງຫອຍ	ບ້ານ ທວງເຊ	ບ້ານ ດອນແກ້ວ
ບ້ານ ຊະໂອ	ບ້ານ ໜາມແທ່ງ	ບ້ານ ຮັງແຮ້ງ	 
ເມືອງ ເລົ່າງາມ ລະຫັດໄປສະນີ 14060 - 14067
ລະຫັດໄປສະນີ ເຂດ 1: 14060
ບ້ານ ຫ້ວຍນຳສັນ	ບ້ານ ໂນນສູງ	ບ້ານ ທົ່ງຂາມ	ບ້ານ ເພົາ
ບ້ານ ເລົ່າງາມ	ບ້ານ ເຕເມສັງທອງ	ບ້ານ ເລນ	ບ້ານ ທົ່ງໂກະ
ບ້ານ ໂນນດູ່	ບ້ານ ປາກທໍ່	ບ້ານ ພໍ່ຫຼົງ	ບ້ານ ໝື່ນປາກດີ
ບ້ານ ໂນນຄຳ	ບ້ານ ງິ້ວ	ບ້ານ ໜອງກາໄຕ້	ບ້ານ ຕະກີດ
ບ້ານ ໂນນເດືອ	ບ້ານ ລະຫວາດ	ບ້ານ ເຕນ	 
ລະຫັດໄປສະນີ ເຂດ 2: 14061
ບ້ານ ດະເຊັຍໃຫຍ່	ບ້ານ ດະເຊັຍນ້ອຍ	ບ້ານ ພໍ່ເຂັມ	ບ້ານ ທົ່ງສຸຍ
ບ້ານ ດອນດູ່	ບ້ານ ມ່ວນແທ້	ບ້ານ ໜອງຕົມ	 
ລະຫັດໄປສະນີ ເຂດ 3: 14062
ບ້ານ ດົງ	ບ້ານ ມ່ວງຊຸມ	ບ້ານ ຫຼວງເສນາ	ບ້ານ ຜັກກູດໃຫຍ່
ບ້ານ ຂະຫຍອງແຂກໃນ	ບ້ານ ຄົວ	ບ້ານ ວັງຍາວ	ບ້ານ ຫ້ວຍແສງ
ບ້ານ ຂະຫຍອງແຂກນອກ	ບ້ານ ເລົ່າໜ້ອງ	 	 
ລະຫັດໄປສະນີ ເຂດ 4: 14063
ບ້ານ ອົ້ນນ້ອຍ	ບ້ານ ຕຸກລຸກ	ບ້ານ ອົ້ນແບ່ງ	ບ້ານ ຫໍກອງ
ບ້ານ ອົ້ນໃຫຍ່	ບ້ານ ເລົ່າຫຍ້າ	ບ້ານ ຫ້ວຍຫູນໄຕ້	ບ້ານ ຫາຍໂສກ
ບ້ານ ພວກໃຫຍ່	ບ້ານ ນ້ຳແບ່ງ	ບ້ານ ຫ້ວຍຫູນເໜືອ	ບ້ານ ເພຍລາດ
ບ້ານ ພວກໃໝ່	ບ້ານ ໜອງຈົວ		 
ລະຫັດໄປສະນີ ເຂດ 5: 14064
ບ້ານ ວັງຄະນານ	ບ້ານ ນາແຊ	ບ້ານ ຍານ	ບ້ານ ກວາງຊີນ້ອຍ
ບ້ານ ສອງຫ້ອງນ້ອຍ	ບ້ານ ສອງຫ້ອງໃຫຍ່	ບ້ານ ໜອງເລົາ	ບ້ານ ວັງແຂ້
ບ້ານ ນາອອມ	 	 	 
ລະຫັດໄປສະນີ ເຂດ 6: 14065
ບ້ານ ໜອງແກ	ບ້ານ ສະຫວ່າງ	ບ້ານ ກະຕວດ	ບ້ານ ນາຈານ
ບ້ານ ດົງຕ້ອງ	ບ້ານ ດົງຫຼວງ	ບ້ານ ກະແບງ	ບ້ານ ກະຊະ
ບ້ານ ໜອງຕົວະ	ບ້ານ ນາທັນ		 
ລະຫັດໄປສະນີ ເຂດ 7: 14066 
ບ້ານ ນາບອນ	ບ້ານ ຄຳທອງ	ບ້ານ ກາງ	ບ້ານ ດົງຊວງ
ບ້ານ ດົງບັງ	ບ້ານ ຂະໜວນ	ບ້ານ ເກັບເຜີ້ງ	ບ້ານ ໜອງເດີນ
ບ້ານ ຝັ່ງລາມ	ບ້ານ ຫ້ວຍເປົ້າ	ບ້ານ ພະນາຍ	ບ້ານ ນາໝີ
ລະຫັດໄປສະນີ ເຂດ 8: 14067
ບ້ານ ຂົວເສັດ	ບ້ານ ບາກໃຫຍ່	ບ້ານ ສະນຶມນອກ	ບ້ານ ສັນທົ່ງ
ບ້ານ ວັງເປືອຍ	ບ້ານ ອິນແປງ	ບ້ານ ສະນຶມໃນ	ບ້ານ ນາກະລອນ
ບ້ານ ເຕເມພໍ່ປູມ	ບ້ານ ອີ່ເລີງ	ບ້ານ ພໍ່ຕອກ	ບ້ານ ຄຽງຕັງເລ
ບ້ານ ພໍ່ນວນ	ບ້ານ ສັນໂນນ	ບ້ານ ຄຽງຕາດສູງ	ບ້ານ ສະນຶມນາ
ເມືອງ ລະຄອນເພັງ ລະຫັດໄປສະນີ 14070 - 14078
ລະຫັດໄປສະນີ ເຂດ 1: 14070
ບ້ານ ລະຄອນສີ	ບ້ານ ຫ້ວຍກະໂພ	ບ້ານ ຄອນສາຍ	ບ້ານ ແກ້ງສະພານທອງ
ບ້ານ ລະຄອນເພັງ	ບ້ານ ນາວາສຸກ		 
ລະຫັດໄປສະນີ ເຂດ 2: 14071
ບ້ານ ນາດູເກົ່າ	ບ້ານ ນາກະເດົາ	ບ້ານ ນາແສນພັນ	ບ້ານ ພູກາສີ
ບ້ານ ນາດູ່ໃໝ່	ບ້ານ ໜອງນົກຂຽນ	ບ້ານ ທ່າຄັນຊຸມແຊວ	ບ້ານ ພູສີແກ້ວ
ບ້ານ ໂຊກແພງ			 
ລະຫັດໄປສະນີ ເຂດ 3: 14072
ບ້ານ ພູຖ້ຳພວງ	ບ້ານ ໂນນສະຫວ່າງ	ບ້ານ ນາພະບາງ	ບ້ານ ນາພະບາງນ້ອຍ
ບ້ານ ນາແລນ	ບ້ານ ໂອກາດ	ບ້ານ ນາທົມ	 
ລະຫັດໄປສະນີ ເຂດ 4: 14073
ບ້ານ ປາກຕາພານ	ບ້ານ ໜອງຍາວ	ບ້ານ ເລິງນົກທາ	ບ້ານ ແກ້ງທັນ
ບ້ານ ໂຮງສາຍທອງ	ບ້ານ ໜອງສະໂນ	ບ້ານ ໂນນແສນພັນ	ບ້ານ ນາໂພສີ
ບ້ານ ປາກສະນົມ	 	 	 
ລະຫັດໄປສະນີ ເຂດ 5: 14074
ບ້ານ ນາທຶນເໜືອ	ບ້ານ ໜອງແສງ	ບ້ານ ດອນເຮືອ	ບ້ານ ດອນໝາກເກືອ
ບ້ານ ນາທຶນໃຕ້	ບ້ານ ດອນແດງ	ບ້ານ ນາກະລາ	ບ້ານ ວັງຕາແຫຼວ
ບ້ານ ນາເມືອງໃຫຍ່	ບ້ານ ໂນນສັງ	ບ້ານ ໂພນງາມ	 
ລະຫັດໄປສະນີ ເຂດ 6: 14075
ບ້ານ ໜອງແວງ	ບ້ານ ວັງແກດ	ບ້ານ ນາສົ້ມໂຮງ	ບ້ານ ນາຂັ້ນໄດ
ບ້ານ ໂນນດິນຊາຍ	ບ້ານ ຫຼັກ 94	ບ້ານ ດົງຕະຫຼຸງ	ບ້ານ ພູດາວແຈ້ງນ້ອຍ
ບ້ານ ນາ	ບ້ານ ຫຼັກ 90		 
ລະຫັດໄປສະນີ ເຂດ 7: 14076
ບ້ານ ພູດາວແຈ້ງໃຫຍ່	ບ້ານ ຄຳເຕີຍ	ບ້ານ ດ່ານນາເລົາ	ບ້ານ ໂພນແພງ
ບ້ານ ໜອງສະໂນ 1	ບ້ານ ດ່ານນ້ອຍ	ບ້ານ ແບ່ງດ່ານ	 
ລະຫັດໄປສະນີ ເຂດ 8: 14077
ບ້ານ ໂພນສູງ	ບ້ານ ໜອງແຕ້	ບ້ານ ສາວແຫວ່ນ	ບ້ານ ໜອງສີ່ແຈ
ບ້ານ ໂພນສະຫວັນ	ບ້ານ ໜອງເທົາ	ບ້ານ ໄຊຊະນະສົມບູນ	ບ້ານ ດອນໄລ່
ບ້ານ ໜອງອ່ຽງ			 
ລະຫັດໄປສະນີ ເຂດ 9: 14078
ບ້ານ ບຸດຕະພານ	ບ້ານ ກຸດລຳພອງ	ບ້ານ ໜອງຂີ້ຕົມ	ບ້ານ ແກ້ງຫຍ້າພືດ
ບ້ານ ນາງລາວ	ບ້ານ ເຕົາຖ່ານ	ບ້ານ ດອນຄັ່ງ	 
 	 	 	 



ແຂວງ ເຊກອງ
ເລກລະຫັດໄປສະນີ 15000
ແຂວງ ເຊກອງ 15xxx		
ເມືອງ ລະມາມ ລະຫັດໄປສະນີ 15000  		
ບ້ານ ໂນນມີໄຊ	ບ້ານ ເພຍໄໝ່	ບ້ານ ປາກໂທນ	ບ້ານ ຫ່ອງໄລ		
ບ້ານ ວັດຫຼວງ	ບ້ານ ທ່າຫຼວງ	ບ້ານ ດາວີ	ບ້ານ ໂນນໜອງຫ້ວາ		
ບ້ານ ໄໝ່ຫົວເມືອງ	ບ້ານ ນາວາແສນ	ບ້ານ ດອນຈັນ	ບ້ານ ໂພນ		
ບ້ານ ໂພນຄໍາ	ບ້ານ ໂມ		 		
ເມືອງ ທ່າແຕ່ງ ລະຫັດໄປສະນີ 15010  		
ບ້ານ ຫ້ວຍຊາຍ	ບ້ານ ໜອງບົວໃສ	ບ້ານ ຫຼັກຂາວ	ບ້ານ ປົງໃໝ່		
ບ້ານ ທ່າແຕ່ງເໜືອ	ບ້ານ ທ່າແຕງໃຕ້	ບ້ານ ປະແຫຼງໃຕ້	ບ້ານ ປະແຫຼງເໜືອ		
ບ້ານ ຫົວເຊໂດນ	ບ້ານ ກົງຕາຢູນ		 		
ເມືອງ ກະລຶມ ລະຫັດໄປສະນີ 15020  		
ບ້ານ ແກ້ງກຽນ	ບ້ານ ສອງຄອນ	ບ້ານ ໂດນ	ບ້ານ ວັງປະງໍ		
ບ້ານ ແກ້ງກຸຍ	ບ້ານ ແຈະ		 		
ເມືອງ ດາກຈຶງ ລະຫັດໄປສະນີ 15030  		
ບ້ານດາກຈຶງ	ບ້ານ ງອນດອນ	ບ້ານ ດາກສາ	ບ້ານ ດາກປໍາ		
ບ້ານ ໂນນສະຫວັນ	ບ້ານ ຕົງສຽງ	ບ້ານ ດາກເອີຍ	ບ້ານ ດາກດີນ		
ບ້ານ ດາກບອງ	ບ້ານ ດາກເຮີນ	 	 		



ແຂວງ ຈຳປາສັກ
ເລກລະຫັດໄປສະນີ 16000
ແຂວງ ຈຳປາສັກ 16xxx				
ເມືອງ ປາກເຊ ລະຫັດໄປສະນີ 16000 - 16003				
ລະຫັດໄປສະນີ ເຂດ 1: 16000				
ບ້ານປາກເຊ	ບ້ານ ທ່າຫີນເໜືອ	ບ້ານ ນາແຫກ	ບ້ານ ຮ່ອງຄະຍອມ				
ບ້ານ ປາກຫ້ວຍເດື່ອ	ບ້ານ ຫ້ວຍປູນ	ບ້ານ ແກ້ວອຸດົມ	ບ້ານ ສາງນ້ຳມັນ				
ບ້ານ ໂພນສະອາດ	ບ້ານ ດົງກະໂລງ	ບ້ານ ໂນນສະຫວ່າງ	ບ້ານ ວັດຫຼວງ				
ບ້ານ ທ່າຫີນໃຕ້	ບ້ານ ແກ	ບ້ານ ສະຫງວນສັກ	 				
ລະຫັດໄປສະນີ ເຂດ 2: 16001				
ບ້ານ ແກ້ງເກີງ	ບ້ານ ຊົງເຊໃຫຍ່	ບ້ານ ພັດທະນາຫຼັກ 7	ບ້ານ ທ່າເຊໃໝ່				
ບ້ານ ຂົວຕະພັນ	ບ້ານ ສ້າງທ່ຽງ	ບ້ານ ສາງວິໄລ	ບ້ານ ໂພນງາມ				
ບ້ານ ດອນສາມສິບ	ບ້ານ ສວນສະຫວັນ	ບ້ານ ທ່າຫຼວງ	ບ້ານ ນາກອກ				
ບ້ານ ຊົ້ງເຊນ້ອຍ	ບ້ານ ຄອນໄຫລ	ບ້ານ ໂພນບົກ	 				
ລະຫັດໄປສະນີ ເຂດ 3: 16002				
ບ້ານ ຫ້ວຍເລົາ	ບ້ານ ທ່າອຸດົມ	ບ້ານ ບຸ່ງອຸດົມ	ບ້ານ ດອນເຂາະ				
ບ້ານ ນາຈຽງ	ບ້ານ ກາງ	ບ້ານ ທ່າຫີນກາງ	ບ້ານ ໂຊກອຳນວຍ				
ບ້ານ ແກ້ວສຳພັນ	ບ້ານ ທ່າສາລາຄຳ	ບ້ານ ກົກເດື່ອ	ບ້ານ ແຮ່				
ບ້ານ ສະໜາມໄຊ	ບ້ານ ພະບາດ	ບ້ານ ໜອງອີ່ເລີງ	 				
ລະຫັດໄປສະນີ ເຂດ 4: 16003				
ບ້ານ ໂພນສະຫວັນ	ບ້ານ ໂພນໄຊ	ບ້ານ ໂພນສີໄຄ	ບ້ານ ພູມ່ວງ				
ບ້ານ ສີບຸນເຮືອງ	ບ້ານ ທ່າໄຮ	ບ້ານ ແກ້ງຊັນ	ບ້ານ ຫ້ວຍຍາງຄໍາເໜືອ				
ບ້ານ ຫ້ວຍຍາງຄຳໄຕ້	ບ້ານ ຄັນເກີງ	ບ້ານ ໂພຕາກ	ບ້ານ ຈັດສັນ				
ບ້ານ ທົ່ງ	ບ້ານ ສະພານໄຊ	ບ້ານ ໂພນກຸງ	 				
ເມືອງ ຈໍາປາສັກລະຫັດໄປສະນີ 16010 - 16013				
ລະຫັດໄປສະນີ ເຂດ 1: 16010				
ບ້ານ ຫົວປາຂໍ້	ບ້ານ ທາງຄົບ	ບ້ານ ໜອງບົວຂາວ	ບ້ານ ໜອງຜຳ				
ບ້ານ ພະພີນ	ບ້ານ ດອນທາງຄວາຍ	ບ້ານ ໜອງບົວ	ບ້ານ ຫ້ວຍເງິນເໜືອ				
ບ້ານ ວັດລະຄອນ	ບ້ານ ໜອງກ່ອນ	ບ້ານ ໜອງແຕ້	ບ້ານ ໂນນສະຫວ່າງ				
ບ້ານ ພະນອນໃຕ້	ບ້ານ ໜອງຂາມ	ບ້ານ ໂນນສຳລານ	 				
ລະຫັດໄປສະນີ ເຂດ 2: 16011				
ບ້ານ ຂອນແກ່ນ	ບ້ານ ໜອງສາ	ບ້ານ ທົມຈານ	ບ້ານ ທ່າໃໝ່				
ບ້ານ ໂພໄຊ	ບ້ານ ໜອງນົກຂຽນ	ບ້ານ ເມີຍ	ບ້ານ ຫ້ວຍເງິນໃຕ້				
ບ້ານ ໂພນແພງ	ບ້ານ ດອນຕະລາດ	ບ້ານ ຫ້ວຍນາ	ບ້ານ ນາຄວາຍ				
ບ້ານ ເມືອງກາງ	ບ້ານ ໜອງສະໂນ	ບ້ານ ທ່າແຕງທ່າ	ບ້ານ ຄັນແຍງ				
ລະຫັດໄປສະນີ ເຂດ 3: 16012				
ບ້ານ ເມືອງແສນ	ບ້ານ ດອນກອງ	ບ້ານ ຫ້ວຍແຫ້	ບ້ານ ວັດທາດ				
ບ້ານ ໄຮ່	ບ້ານ ທ່າແຕງເທິງ	ບ້ານ ຫ້ວຍມັນປາ	ບ້ານ ກະຕຶບ				
ບ້ານ ສີສະຫວ່າງ	ບ້ານ ເປືອຍ	ບ້ານ ນາດົງ	ບ້ານ ໜອງຫໍ				
ບ້ານ ໜອງເດີ່ນ	ບ້ານ ໂດ່	ບ້ານ ວັດໄຊ	ບ້ານ ທາງແບ່ງ				
ບ້ານ ສ້າງແຄນ	ບ້ານ ພົງໂພດ	ບ້ານ ວັດທົ່ງ	ບ້ານ ນາສະຫວ່າງ				
ລະຫັດໄປສະນີ ເຂດ 4: 16013				
ບ້ານ ໜອງໝາກແກ້ວ	ບ້ານ ດອນຊຽງຫຼ້າ	ບ້ານ ໜອງວຽນ	ບ້ານ ຄຳຈະເລີນ				
ບ້ານ ຫຼັກແບ່ນ	ບ້ານ ດອນກອຍ	ບ້ານ ຫ້ວຍສາຫົວ	ບ້ານ ງົວບາ				
ບ້ານ ໜອງຫໍ	ບ້ານ ພັນທະຄານ	ບ້ານ ໂຄກກ່ອງ	ບ້ານ ສີສຸລາດ				
ບ້ານ ໂນນດີ	ບ້ານ ວັດອາມາດ	ບ້ານ ໜອງຫີນ	ບ້ານ ທ່າຕານ				
ບ້ານ ສົ້ມໂຮງ	ບ້ານ ວັດຫຼວງເກົ່າ	ບ້ານ ໂນນທາຍ	ບ້ານ ໃໝ່ກາງ				
 	 	 	ບ້ານ ດອນຮີ				
ເມືອງໂຂງ ລະຫັດໄປສະນີ 16020 - 16027				
ລະຫັດໄປສະນີ ເຂດ 1: 16020				
ບ້ານກາງໂຂ	ບ້ານ ແສນເໜື່ອ	ບ້ານ ຫາດ	ບ້ານ ທ່າມ່ວງ				
ບ້ານ ພິມານໂພນ	ບ້ານ ດອນຫວດ	ບ້ານ ໂພນສະຫວັນ	ບ້ານ ພະເພັງ				
ບ້ານ ຫ້ວຍ	ບ້ານ ນາສົ້ມໂຮງ	ບ້ານ ເສັດນ້ຳອ້ອມ	ບ້ານ ດອນສີສົມ				
ບ້ານ ຫົວໂຂງແຫຼມ	ບ້ານ ນາແວງ	ບ້ານ ແສນໂຮມ	ບ້ານ ດອນເດດອອກ				
ລະຫັດໄປສະນີ ເຂດ 2: 16021				
ບ້ານ ລົດພັດ	ບ້ານ ຫາງສົມ	ບ້ານ ຫົວໂລງ	ບ້ານ ດອນຄັນ				
ບ້ານ ອຸບປະຊາ	ບ້ານ ເດື່ອເໜືອ	ບ້ານ ໂລງກາງ	ບ້ານ ໂຂງເໜືອ				
ບ້ານ ບຸ່ນນ້ອຍ	ບ້ານ ຫາງຊ້າງໄຟ	ບ້ານ ເວີນທອງ	ບ້ານ ແສນໃຕ້				
ບ້ານ ທ່າໝາກເຫັບ	ບ້ານ ລົບປະດີນາ	ບ້ານ ໂພໄຊ	ບ້ານ ຫ້ວຍໄຜ່				
ລະຫັດໄປສະນີ ເຂດ 3: 16022				
ບ້ານ ນາຄອງແຄະ	ບ້ານ ນາປາກຽບ	ບ້ານ ດອນຕານຕົກ	ບ້ານ ໂສງເປືອຍ				
ບ້ານ ຫົວແກ້ງ	ບ້ານ ເສັດເຕົາເຫຼັກ	ບ້ານ ດອນເດດຕົກ	ບ້ານ ທ່າຂາມ				
ບ້ານ ໂພນແດງ	ບ້ານ ໂພນໂພ	ບ້ານ ເຕົາປຸງ	ບ້ານ ດອນເປືອຍ				
ບ້ານ ດອນແຄ	ບ້ານ ຄອນເມືອງ	ບ້ານ ແກ້ງ	ບ້ານ ເດື່ອໃຕ້				
ລະຫັດໄປສະນີ ເຂດ 4: 16023				
ບ້ານ ລົບປະດີ	ບ້ານ ຫາງໂຂງ	ບ້ານ ບຸ່ງ	ບ້ານ ຫີນຮອງ				
ບ້ານ ລົບປະດີໂພນຕາກ	ບ້ານ ແສນລ່າມ	ບ້ານ ໂສງເປື່ອຍ	ບ້ານ ກ້ອງແກ້ງ				
ບ້ານ ໂລງໂຊ້ງ	ບ້ານ ສັນບ້ານໂພນ	ບ້ານ ນາເຊືອກ	ບ້ານ ໂສດ				
ບ້ານ ຖານຕາເວັນອອກ	ບ້ານ ແສນຫາດໃຫຍ່	ບ້ານ ນົກກົກ	ບ້ານ ເສັດສະຫວັນ				
ລະຫັດໄປສະນີ ເຂດ 5: 16024				
ບ້ານ ດອນຈອມ	ບ້ານ ກົກປາແດກ	ບ້ານ ດອນຊ້າງ	ບ້ານ ຫົວຮີ້ນ້ອຍ				
ບ້ານ ຄອນໃຕ້	ບ້ານ ດອນຂະເໝົາ	ບ້ານ ສາລາ	ບ້ານ ຖານຕາເວັນຕົກ				
ບ້ານ ດອນຕານອອກ	ບ້ານ ທ່າໂພ	ບ້ານ ລົບປະດີໂພນທັນ	ບ້ານ ນາ				
ບ້ານ ດອນແອ່ນ	ບ້ານ ສົມວັນອອກ	ບ້ານ ດອນສົ້ມໂຮງ	ບ້ານ ຊຽງຫວາງ				
ລະຫັດໄປສະນີ ເຂດ 6: 16025				
ບ້ານ ຫົວສັນ	ບ້ານ ໂພນວິໄຊ	ບ້ານ ພຽງດີ	ບ້ານ ຫົວສະດຳ				
ບ້ານ ແສນຫາດນ້ອຍ	ບ້ານ ຫາດຊາຍຄູນ	ບ້ານ ເວີນຄາມ	ບ້ານ ຫ້ວຍໄຮ				
ບ້ານ ສາມຄ້າງ	ບ້ານ ກະດັນ	ບ້ານ ບຶງງາມ	ບ້ານ ນາລານ				
ບ້ານ ໂສງຍາງ	ບ້ານ ຊົນລະວຽງ	ບ້ານ ຫາງຄອນ	ບ້ານ ດອນຫໍ່ເຂົ້າ				
ລະຫັດໄປສະນີ ເຂດ 7: 16026				
ບ້ານ ທ່າພ້າວ	ບ້ານ ລົບປະດີກາງ	ບ້ານ ໂພສີ	ບ້ານ ນາແສນພັນ				
ບ້ານ ສົມວັນຕົກ	ບ້ານ ດອນໂຈນ	ບ້ານ ໂຂງທາດງີ້ວ	ບ້ານ ໂພນສະອາດ				
ບ້ານ ທໍລະນີ	ບ້ານ ຫາງຮີ້ນ້ອຍ	ບ້ານ ດອນເຫຼັກໄຟ	ບ້ານ ເວີນຂາວ				
ບ້ານ ມ່ວງ	ບ້ານ ດົງ	ບ້ານ ໂພນຕານ	ບ້ານ ຂີ້ນາກ				
ລະຫັດໄປສະນີ ເຂດ 8: 16027				
ບ້ານ ນາສົງເປືອຍ	ບ້ານ ດອນສະໂຮງ	ບ້ານ ມ່ວງ	ບ້ານ ຫົວຊ້າງໄຟ				
ບ້ານ ຫາດຂີ້ຄວາຍ	ບ້ານ ຫາງສະດຳ	ບ້ານ ແກ້ງກຸ່ມ	ບ້ານ ລົບປະດີເກົ່າ				
ບ້ານ ນາກະສັງ	ບ້ານ ຈານ	ບ້ານ ເວີນສົມ	ບ້ານ ລົບປະດີຄອນນ້ອຍ				
ບ້ານ ທ່າຄໍ້	ບ້ານ ນາຝັ່ງ	ບ້ານ ນາວຄວັດ	ບ້ານ ດອນກະເດັນ				
ເມືອງ ມຸນລະປະໂມກ ລະຫັດໄປສະນີ 16030 - 16033				
ລະຫັດໄປສະນີ ເຂດ 1: 16030				
ບ້ານ ທ່າຄໍ້	ບ້ານ ໜອງຫອຍ	ບ້ານ ທ່າຫີນ	ບ້ານ ທ່ານນ້ອງ				
ບ້ານ ໃໝ່	ບ້ານ ຮີເວີນ	ບ້ານ ຂະເໝົາກາງ	ບ້ານ ດອນເປືອຍ				
ບ້ານດອນນາງລອຍບ້ານນາ	ບ້ານ ຫາງດອນກອຍ	ບ້ານ ໜອງຊາ	ບ້ານ ລວງໂຊ້				
ບ້ານ ຊານົນ	ບ້ານ ນາດີ	ບ້ານ ກະດຽມ	ບ້ານ ກ້ວຍ				
ບ້ານ ຊຽງຫວາງ	ບ້ານ ສະເຫົາໂສງ		 				
ລະຫັດໄປສະນີ ເຂດ 2: 16031				
ບ້ານ ໂນນສະຫວ່າງ	ບ້ານ ເວີນທ່າຊ້າງ	ບ້ານ ເຂັມ	ບ້ານ ໜອງບົວທອງ				
ບ້ານ ນາຕານ	ບ້ານ ເວີນຍາງ	ບ້ານ ທ່ານແຮ່	ບ້ານ ເດື່ອເຕ້ຍ				
ບ້ານ ຮີທາດ	ບ້ານ ດອນເຄົາ	ບ້ານ ດອນນາງລອຍ	ບ້ານ ຫ້ວຍຍາງ				
ບ້ານ ດອນແຮດ	ບ້ານ ຂະເໝົາປາກເຊ	ບ້ານ ໄຄ້ດ່ຽວ	ບ້ານ ຫົວດອນກອຍ				
ລະຫັດໄປສະນີ ເຂດ 3: 16032				
ບ້ານ ຫ້ວຍໂກ	ບ້ານ ຂະເໝົາໂພນເປືອຍ	ບ້ານ ເວີນແຄນ	ບ້ານ ຮີນາຄອນ				
ບ້ານ ໂພນດູ່	ບ້ານ ປໍ	ບ້ານ ປະໂມກເໜືອ	ບ້ານ ນາກາງ				
ບ້ານ ທ່າກັງ	ບ້ານ ເວີນເໜືອ	ບ້ານ ສະພັງເໜືອ	ບ້ານ ທ່າໝັ້ນ				
ບ້ານ ຫົວຂະເໝົາ	ບ້ານ ດອນນາງລອຍບ້ານໃຫຍ່	ບ້ານ ທ່າເດື່ອ	ບ້ານ ການເຫືອງ				
ລະຫັດໄປສະນີ ເຂດ 4: 16033				
ບ້ານ ຂະເໝົາພູແມວ	ບ້ານ ດອນນາງລອຍກາງ	ບ້ານ ດອນຮີ	ບ້ານ ຫີນລາດ				
ບ້ານ ຫາງຂະເໜົາ	ບ້ານ ປ່ານ້ອຍ	ບ້ານ ຫາງດອນຮີ	ບ້ານ ຂະເມົາຫ້ວຍຫຼວງ				
ບ້ານ ເປວ	ບ້ານ ປະໂມກກາງ	ບ້ານ ຫ້ວຍແຮດ	ບ້ານ ຫ້ວຍຊາຍ				
ບ້ານ ເວີນໃຕ້	ບ້ານ ສະພັງໃຕ້	ບ້ານ ຊານຫວ້າ	ບ້ານ ກະດັນກາງ				
ເມືອງ ສຸຂູມາ ລະຫັດໄປສະນີ 16040 - 16042				
ລະຫັດໄປສະນີ ເຂດ 1: 16040				
ບ້ານ ສຸຂຸມາເໜືອ	ບ້ານ ດົງຍາງ	ບ້ານ ປາກຊ້າງ	ບ້ານ ຫ້ວຍເລກ				
ບ້ານ ບົກ	ບ້ານ ໝາກມີ້	ບ້ານ ສຸຂູມາໃຕ້	ບ້ານ ປ່າກ້ວຍ				
ບ້ານ ໂຄກສະຫວ່າງ	ບ້ານ ທາດໂນນຍາງ	ບ້ານ ລາດ	ບ້ານ ໄໝ່ວົງໝາກແສວ				
ບ້ານ ແຮ່	ບ້ານ ດອນຂັ້ນເທິງ	ບ້ານ ໝາກໂງະ	ບ້ານ ທາດ				
ບ້ານ ທ່າໂພສີ	 	 	 				
ລະຫັດໄປສະນີ ເຂດ 2: 16041				
ບ້ານ ດອນຫວາຍ	ບ້ານ ໂພນ	ບ້ານ ອຸທຸມໃໝ່	ບ້ານ ໂນນແດງເໜືອ				
ບ້ານ ດອນຄອກງົວ	ບ້ານ ປ່າກໍ່	ບ້ານ ກອກ	ບ້ານ ກູດຕະບູນ				
ບ້ານ ຫຽງ	ບ້ານ ບຸ່ງແກ້ວ	ບ້ານ ໜອງພັນວົງ	ບ້ານ ໂຄກໜອງບົວ				
ບ້ານ ທັບຈານ	ບ້ານ ໜອງນົກກວຽນ	ບ້ານ ຍາງສາວ	ບ້ານ ບາກ				
ລະຫັດໄປສະນີ ເຂດ 3: 16042				
ບ້ານ ທ່າແສງ	ບ້ານ ໂນນພະເຈົ້າ	ບ້ານ ມ່ວງ	ບ້ານ ຫົວດອນໄຊ				
ບ້ານ ທ່າດ່ານ	ບ້ານ ດອນກາງ	ບ້ານ ສາມຂາ	ບ້ານ ຕູມໃຫຍ່				
ບ້ານ ອຸທຸມເກົ່າ	ບ້ານ ຫ້ວຍເຜີ້ງ	ບ້ານ ດົງຫົວບ້ານ	ບ້ານ ແສນເໜືອ				
ບ້ານ ຕູມນ້ອຍ	ບ້ານ ໂພນເຜິ້ງ	ບ້ານ ຫ້ວຍໄຜ່	ບ້ານ ໂນນຍາງ				
ເມືອງ ປະທຸມພອນ ລະຫັດໄປສະນີ 16050 - 16055				
ລະຫັດໄປສະນີ ເຂດ 1: 16050				
ບ້ານຫລັກ 40	ບ້ານ ຫຼັກ 19	ບ້ານ ໜອງແຂ	ບ້ານ ສະໂນດ				
ບ້ານ ຄອນນ້ອຍ	ບ້ານ ນ້ຳໃສລຸ່ມ	ບ້ານ ພະຫຼວງ	ບ້ານ ທົງໄຊ				
ບ້ານ ຫຼັກ 13	ບ້ານ ຫົວດອນແດງ	ບ້ານ ໜອງບົວນ້ອຍ	ບ້ານ ກະລະ				
ບ້ານ ຫຼັກ 20	ບ້ານ ສີຈັນໂທ	ບ້ານ ທ່າກວ້າງ	 				
ລະຫັດໄປສະນີ ເຂດ 2: 16051				
ບ້ານ ພັກຂະ	ບ້ານ ໜອງບຶກ	ບ້ານ ໝໍ້ພຸ	ບ້ານ ປະທຸມພອນ				
ບ້ານ ໜອງປີງ	ບ້ານ ປາກຕວຍ	ບ້ານ ນ້ຳໃສເທິງ	ບ້ານ ຫ້ວຍໄຜ່				
ບ້ານ ນາບອນ	ບ້ານ ນາລາດ	ບ້ານ ບັງຊາຍ	ບ້ານ ບຸ່ນໃຫຍ່				
ບ້ານ ນ້ຳອ້ອມ	ບ້ານ ຫຼັກ 24	ບ້ານ ຕານປ່ຽວ	 				
ລະຫັດໄປສະນີ ເຂດ 3: 16052				
ບ້ານ ປ່າອາວ	ບ້ານ ໂພນງາມ	ບ້ານ ຫຼັກ 30	ບ້ານ ຫຼັກ 31				
ບ້ານ ຫ້ວຍໂກະ	ບ້ານ ຕະອອງ	ບ້ານ ໂນນສະຫວ່າງ	ບ້ານ ສີມຸງຄຸນ				
ບ້ານ ກະແລໃຫຍ່	ບ້ານ ເລົ່າຫຍ້າ	ບ້ານ ຫຼັກ 25	ບ້ານ ຫຼັກ 48				
ບ້ານ ຫ້ວຍໝາກ	ບ້ານ ນາຄຳ	ບ້ານ ນ້ຳໃສທ່າ	 				
ລະຫັດໄປສະນີ ເຂດ 4: 16053				
ບ້ານ ແຊງ	ບ້ານ ພົມມະລື	ບ້ານ ຕວຍ	ບ້ານ ເວີນ				
ບ້ານ ຫ້ວຍແມ່ສັງ	ບ້ານ ທົ່ງພະ	ບ້ານ ສົມສຸກ	ບ້ານ ນ້ຳພາກ				
ບ້ານ ໃໝ່	ບ້ານ ກະແລໃໝ່	ບ້ານ ນາຂາມ	ບ້ານ ປາກຫ້ວຍ				
ບ້ານ ຫ້ວຍຍາງ	ບ້ານ ບຶງໂຄະ	ບ້ານ ຫຼັກ 41	 				
ລະຫັດໄປສະນີ ເຂດ 5: 16054				
ບ້ານ ຫຼັກ 34	ບ້ານ ໜອງບົວໃຫຍ່	ບ້ານ ແກ້ງນາງອ່າງ	ບ້ານ ໜອງເອກ				
ບ້ານ ຊຽງຫວາງ	ບ້ານ ພອງເພາະ	ບ້ານ ພະໂພ	ບ້ານ ໂຕະໂມະທ່າ				
ບ້ານ ນາລານ	ບ້ານ ກຽດໂງ້ງ	ບ້ານ ພະລາຍບົກ	ບ້ານ ສີສຸກ				
ບ້ານ ນາໂພ	ບ້ານ ນາທົ່ງ	ບ້ານ ຈົ່ງຮ່ວຍ	 				
ລະຫັດໄປສະນີ ເຂດ 6: 16055				
ບ້ານ ຜັກແພວ	ບ້ານ ເປືອຍດ້າວ	ບ້ານ ນາ	ບ້ານ ພາລາຍທົ່ງ				
ບ້ານ ບັງລຽງໃນ	ບ້ານ ນາກອນ	ບ້ານ ທົບສອກ	ບ້ານ ຕະວ່າງ				
ບ້ານ ຫຼັກ 29	ບ້ານ ທ່າຮູ້	ບ້ານ ສະໝິງ	ບ້ານ ໜອງຫີນ				
ບ້ານ ມ່ວງ	ບ້ານ ຫ້ວຍເກືອ	ບ້ານ ຄອນທູດ	ບ້ານ ຫ້ວຍຕ້ອນ				
ເມືອງ ໂພນທອງ ລະຫັດໄປສະນີ 16060 - 16066 				
ລະຫັດໄປສະນີ ເຂດ 1: 16060				
ບ້ານໂພໄຊ	ບ້ານ ໜອງເມັກ	ບ້ານ ຫີນໂງມ	ບ້ານ ໂພນສັນ				
ບ້ານ ດອນໄຫຼ່	ບ້ານ ນາສະຫວ່າງ	ບ້ານ ໂນນສະອາດ	ບ້ານ ດູ່				
ບ້ານ ໂນນສະຫວ່າງ	ບ້ານ ໂນນພະເຈົ້າ	ບ້ານ ພູມສະຫວັນ	ບ້ານ ໜອງໄຮໂຄກ				
ບ້ານ ນາຫ້ວາ	ບ້ານ ໂນນກຸງ	ບ້ານ ໂນນຫາດ	ບ້ານ ດົງຍາງ				
ລະຫັດໄປສະນີ ເຂດ 2: 16061				
ບ້ານ ດອນໂຈດ	ບ້ານ ໜອງໄຮທ່າ	ບ້ານ ໜອງບົວ	ບ້ານ ນາສົມບູນ				
ບ້ານ ທົ່ງກວ້າງ	ບ້ານ ຂະໜາດ	ບ້ານ ທ່າກູ	ບ້ານ ໜອງຫີນ				
ບ້ານ ກຸດນ້ຳຂຸ່ນ	ບ້ານ ສະໝັນ	ບ້ານ ໜອງຫອຍ	ບ້ານ ແກ້ງຍາວ				
ບ້ານ ໂນນຄູນ	ບ້ານ ວັດຫໍພະແກ້ວ	ບ້ານ ໂພນໃຫຍ່	ບ້ານ ພະລິງ				
ລະຫັດໄປສະນີ ເຂດ 3: 16062				
ບ້ານ ອຸປະຫຼາດ	ບ້ານ ບົກ	ບ້ານ ນາອຸດົມ	ບ້ານ ລວງຕົມ				
ບ້ານ ໃໝ່ສີວິໄລ	ບ້ານ ໃໝ່	ບ້ານ ໂຄກກອງ	ບ້ານ ມ່ວງ				
ບ້ານ ໂນນຫີນ	ບ້ານ ດ່ານນາວຽງ	ບ້ານ ໂນນຊັບ	ບ້ານ ໜອງສາ(ວັງຊອນ)				
ບ້ານ ໂພຄຳ	ບ້ານ ວັງເຕົ່າ	ບ້ານ ສີມຸງຄຸນ	ບ້ານ ໂນນສັງ				
ລະຫັດໄປສະນີ ເຂດ 4: 16063				
ບ້ານ ຫ້ວຍເພັກ	ບ້ານ ດອນຂວາງ	ບ້ານ ຝັ່ງແດງ	ບ້ານ ໝໍ້				
ບ້ານ ດອນຊາດ	ບ້ານ ທ່ານ້ອຍ	ບ້ານ ກຸງ	ບ້ານ ໜອງລາດ				
ບ້ານ ໜອງແຕ້ນ້ອຍ	ບ້ານ ສະໝໍລຽບ	ບ້ານ ໂພໄຊ	ບ້ານ ອ່າງສີລາ				
ບ້ານ ໜອງຜື	ບ້ານ ຫຼັກ 8	ບ້ານ ໂຄກກຸງ	ບ້ານ ປ້ອງ				
ລະຫັດໄປສະນີ ເຂດ 5: 16064				
ບ້ານ ກະຕິນ	ບ້ານ ສະໝໍໂຍນ	ບ້ານ ນາຈານ	ບ້ານ ທ່າໃຫຍ່				
ບ້ານ ຄັນແຍງ	ບ້ານ ທົ່ງຄູ່ເມືອງ	ບ້ານ ກ້ວຍ	ບ້ານ ທ່າໂພສີ				
ບ້ານ ເວີນໄຊໃຫຍ່	ບ້ານ ໂນນສະຫວັນ	ບ້ານ ວັງອິລິດ	ບ້ານ ຫຼັກ 12				
ບ້ານ ສັກເມືອງເໜືອ	ບ້ານ ຄັນແຍງ	ບ້ານ ສອງຄອນ	ບ້ານ ໂນນຈຳປາ				
ລະຫັດໄປສະນີ ເຂດ 6: 16065				
ບ້ານ ຈິກ	ບ້ານ ແກ້ງກາງ	ບ້ານ ນາຫວ້າ	ບ້ານ ທ່າຫຼວງ				
ບ້ານ ໂພແກ້ວ	ບ້ານ ໜອງສາລາ	ບ້ານ ເວີນໄຊນ້ອຍ	ບ້ານ ຫ້ວຍໂດນ				
ບ້ານ ດອນຈິກ	ບ້ານ ໂພນງາມ	ບ້ານ ສັກເມືອງໃຕ້	ບ້ານ ສະເຫຼົ້າ				
ບ້ານ ໜອງດົງ	ບ້ານ ດອນສ້າງໄພ	ບ້ານ ຊົ້ງຊາຍ	ບ້ານ ໂພນນ້ອຍ				
ລະຫັດໄປສະນີ ເຂດ 7: 16066				
ບ້ານ ໄຜ່ລ້ອມ	ບ້ານ ນາສົມຫວັງ	ບ້ານ ອຸສຸ	ບ້ານ ສະຫວ່າງ				
ບ້ານ ອ່າງຄຳ	ບ້ານ ມ່ວງຄຳ	ບ້ານ ໄຮຢ່ອງ	ບ້ານ ເລົາ				
ບ້ານ ໂນນສະອາດ	ບ້ານ ແກ	ບ້ານ ໂຄກສະຫວ່າງ	ບ້ານ ກົກລຳແຊງ				
ບ້ານ ບຸງແກ	ບ້ານ ໂນນດູ່	ບ້ານ ຂຸມທອງ	ບ້ານ ຫາດຂີ້ກາ				
ບ້ານ ດອນຕະແບງ	ບ້ານ ມີໄຊ	ບ້ານ ໜອງແສງ	 				
ເມືອງ ຊະນະສົມບູນ ລະຫັດໄປສະນີ 16070 - 16074  				
ລະຫັດໄປສະນີ ເຂດ 1: 16070				
ບ້ານ ຊອນພາກ	ບ້ານ ກະຕິນໃຫຍ່	ບ້ານ ເດື່ອໃຕ້	ບ້ານ ຫົວແຊ				
ບ້ານ ສີທວນ	ບ້ານ ໂພໄຊ	ບ້ານ ໂຊໂລໃຫຍ່	ບ້ານ ຕ້າງລ້າງ				
ບ້ານ ບຸ່ງຄ້າ	ບ້ານ ດອນເພັກ	ບ້ານ ຄຳແປງ	ບ້ານ ທົ່ງຮີນ້ອຍ				
ບ້ານ ສຸລະ	ບ້ານ ໂນນຊາດ	ບ້ານ ລຸຍໃຕ້	ບ້ານ ແກ້ງໂພ				
ລະຫັດໄປສະນີ ເຂດ 2: 16071				
ບ້ານ ຫີນລາດ	ບ້ານ ຫ້ວຍຍາງນ້ອຍ	ບ້ານ ຄັນສວນມອນ	ບ້ານ ນາໃນ				
ບ້ານ ນາຫຼັກ	ບ້ານ ໂຢງເໜືອ	ບ້ານ ແກ້ງກອກ	ບ້ານ ນາຂາມ				
ບ້ານ ໂສກກຸງ	ບ້ານ ດອນໂຄ	ບ້ານ ປົ່ງສ້ານ	ບ້ານ ທົ່ງຮີໃຫຍ່				
ບ້ານ ປົ່ງ	ບ້ານ ປາກຊອນ	ບ້ານ ຄຳເມັກ	ບ້ານ ນາຫົວພູ				
ລະຫັດໄປສະນີ ເຂດ 3: 16072				
ບ້ານ ປາກປ່າກັ້ງ	ບ້ານ ຫ້ວຍຍາງໃຫຍ່	ບ້ານ ທາດ	ບ້ານ ຄຳຫຼວງ				
ບ້ານ ນາຫຼົ້ງ	ບ້ານ ໂຢງກາງ	ບ້ານ ພູທອງລຸ່ມ	ບ້ານ ໜອງໄຜ່				
ບ້ານ ນາແກວ	ບ້ານ ນາຂວ້າງ	ບ້ານ ດອນແຊ	ບ້ານ ນາດ່ານ				
ບ້ານ ລາດເໜືອ	ບ້ານ ໜອງຫອຍ	ບ້ານ ນາງາມ	ບ້ານ ເລົ່າ				
ລະຫັດໄປສະນີ ເຂດ 4: 16073				
ບ້ານ ຄຳບອນ	ບ້ານ ໜອງເມັກ	ບ້ານ ໜອງໂນ	ບ້ານ ຄຳງົວ				
ບ້ານ ວັງເວີນໃຫຍ່	ບ້ານ ງິ້ວ	ບ້ານ ງົວແດງ	ບ້ານ ໜອງດູ່				
ບ້ານ ດົງລານຄຳ	ບ້ານ ສົ້ມໂຮງ	ບ້ານ ຈຳປີ	ບ້ານ ຄີລີ				
ບ້ານ ມ່ວງ	ບ້ານ ທາງແບ່ງສີວິໄລ	ບ້ານ ດົງ	ບ້ານ ໂພນທາດ				
ລະຫັດໄປສະນີ ເຂດ 5: 16074				
ບ້ານແກ້ງໄມ້ເຮ້ຍລຸ່ມ	ບ້ານ ສິງສຳພັນ	ບ້ານ ແກ້ງແກວ	ບ້ານ ຄຳຢາດ				
ບ້ານ ຫົວພູ	ບ້ານ ກະຕິນນ້ອຍ	ບ້ານ ໂຊໂລນ້ອຍ	ບ້ານ ແຊລະບຳ				
ບ້ານ ວັງເວີນນ້ອຍ	ບ້ານ ໂພນແກ້ວ	ບ້ານ ໜອງຂາມ	ບ້ານ ແກ້ງໄມ້ເຮ້ຍເທິງ				
ບ້ານ ທາງແບ່ງຫຼັກ 17	ບ້ານ ນາຊອນ	ບ້ານ ໜອງແຄນ	ບ້ານ ປົ່ງເກີມ				
ບ້ານ ອອກເມືອງ	ບ້ານ ສະລິ	ບ້ານ ໜອງນົກຂຽນ	 				
ເມືອງ ປາກຊ່ອງລະຫັດໄປສະນີ 16080 - 16086				
ລະຫັດໄປສະນີ ເຂດ 1: 16080				
ບ້ານພູເຂົາທອງ	ບ້ານ ສົມສະນຸກໃຫຍ່	ບ້ານ ໜອງສຳພັນ	ບ້ານ ພະໜວນດົງ				
ບ້ານ ໜອງຂິງຄໍາ	ບ້ານ ຜັກກູດໃຫຍ່	ບ້ານ ແບງ	ບ້ານ ຫຼັກ 12				
ບ້ານ ຫຼັກ 42	ບ້ານ ໂນນສະຫວ່າງ	ບ້ານ ພູມາກກໍ	ບ້ານ ໜອງເຄືອງລັບ				
ບ້ານ ຫຼັກ 28	ບ້ານ ໜອງຢາເທິງ	ບ້ານ ເຊປ່ຽນ	ບ້ານ ຈັດສັນໃຫມ່				
ລະຫັດໄປສະນີ ເຂດ 2: 16081				
ບ້ານ ອຸບປະຊາ	ບ້ານ ແກ້ວຄູນເມືອງ	ບ້ານ ຫ້ວຍຈຽດ	ບ້ານ ໜອງແລະ				
ບ້ານ ໜອງພະໜວຍ	ບ້ານ ໜອງບຶງແກ້ວ	ບ້ານ ສົມສະນຸກເກົ່າ	ບ້ານ ໜອງຢາລຸ່ມ				
ບ້ານ ເຊນ້ຳນ້ອຍ	ບ້ານ ຫຼັກ 48	ບ້ານ ຜັກກູດນ້ອຍ	ບ້ານ ເສັດຄົດ				
ບ້ານ ນ້ຳຕຽງ	ບ້ານ ຫຼັກ 40		 				
ລະຫັດໄປສະນີ ເຂດ 3: 16082				
ບ້ານ ກະຕວດ	ບ້ານ ຫຼັກ 15	ບ້ານ ຈອດ	ບ້ານ ວັດຫຼວງ				
ບ້ານ ໜອງຫຼວງ	ບ້ານ ຫ້ວຍກອງ	ບ້ານ ພູດິນອ່ອນ	ບ້ານ ຫຼັກ 47				
ບ້ານ ປາກບ້ອງ	ບ້ານ ໜອງເມັກ	ບ້ານ ນ້ຳເລງ	ບ້ານ ຫຼັກ 38				
ບ້ານ ຫ້ວຍຊາດ	ບ້ານ ຕະໂອດ	ບ້ານ ນາຢິກເສືອ	 				
ລະຫັດໄປສະນີ ເຂດ 4: 16083				
ບ້ານ ຄົດໃຫຍ່	ບ້ານ ພູດ້າມຂວັນ	ບ້ານ ທົ່ງຫວ້າ	ບ້ານ ນ້ຳຮຸ່ງ				
ບ້ານ ໜອງບອນ	ບ້ານ ຫີນຂາວ	ບ້ານ ຫີນລັບ	ບ້ານ ໜອງຫີນ				
ບ້ານ ພູດິນແດງ	ບ້ານ ລີເຈືອງ	ບ້ານ ຈັນສະຫວ່າງ	ບ້ານ ນ້ຳກົງ				
ບ້ານ ໜອງກະລິ	ບ້ານ ທົ່ງກະຕ່າຍ	ບ້ານ ໜອງກິນ
 				
ລະຫັດໄປສະນີ ເຂດ 5: 16084				
ບ້ານ ໜອງກາ	ບ້ານ ຫຼັກ 36	ບ້ານ ຫ້ວຍຊັນ	ບ້ານ ກົງຕາຢູນ				
ບ້ານ ນ້ຳຕວດ	ບ້ານ ຄົດນ້ອຍ	ບ້ານ ພູມອນ	ບ້ານ ຫຼັກ 5				
ບ້ານ ປາກຊ່ອງ	ບ້ານ ໃໝ່ໄຊສົມບູນ	ບ້ານ ທົ່ງເສັດ	ບ້ານ ຫ້ວຍຊອຍ				
ບ້ານ ຫຼັກ 45	ບ້ານ ກະເພີ		 				
ລະຫັດໄປສະນີ ເຂດ 6: 16085				
ບ້ານ ໂນນຈັນ	ບ້ານ ໜອງເທືອມ	ບ້ານ ບັງລຽງ	ບ້ານ ຫ້ວຍເຕົ່າ				
ບ້ານ ໜອງເຄືອງໃໝ່	ບ້ານ ຫ້ວຍຊອນ	ບ້ານ ຫຼັກ 43	ບ້ານ ພູດິນ				
ບ້ານ ທົ່ງຫວາຍ	ບ້ານ ທົ່ງກາຫຼົງ	ບ້ານ ຫຼັກ 30	ບ້ານ ພູຫຼັງແກ້ວ				
ບ້ານ ໜອງຕວງ	ບ້ານ ຫ້ວຍເຕີຍ		 				
ລະຫັດໄປສະນີ ເຂດ 7: 16086				
ບ້ານ ເຊຕະປຸງ	ບ້ານ ຕາດສະເມັກ	ບ້ານ ນ້ຳຕ່າງ	ບ້ານ ດອນໂຂງ				
ບ້ານ ແດງສະຫວ່າງ	ບ້ານ ຫົວຊ້າງ	ບ້ານ ໜອງອີໂອຍ	ບ້ານ ທົ່ງຢາວ				
ບ້ານ ກອງຕຸ່ມ	ບ້ານ ຫຼັກ 11	ບ້ານ ລາຊາສິນ	ບ້ານ ຫ້ວຍຫວາຍ				
ບ້ານ ພູໝາກນາວ	ບ້ານ ນ້ຳປົດ	 	 				
ເມືອງ ບາຈຽງ ລະຫັດໄປສະນີ 16090 - 16095				
ລະຫັດໄປສະນີ ເຂດ 1: 16090				
ບ້ານ ໜອງກອກ	ບ້ານ ທົ່ງສີວິໄລ	ບ້ານ ລົມສັກເໜືອ	ບ້ານ ຫ້ວຍສົ້ມ				
ບ້ານ ໜອງຫົວຄວາຍ	ບ້ານ ຫ້ວຍຕ້ອງ	ບ້ານ ສະບອງ	ບ້ານ ລາດບົກ				
ບ້ານ ໂນນສອນ	ບ້ານ ດົງ	ບ້ານ ໜອງກັ້ງ	ບ້ານ ໜອງບົວ				
ບ້ານ ທີ 4	ບ້ານ ຫຼັກ 22	ບ້ານ ໜອງບົກໃຫຍ່	 				
ລະຫັດໄປສະນີ ເຂດ 2: 16091				
ບ້ານ ສະຫວ່າງ	ບ້ານ ໜອງບົກນ້ອຍ	ບ້ານ ມ່ວງໄຂ່	ບ້ານ ປາກຫ້ວນເດື່ອ				
ບ້ານ ຫຼັກ 16	ບ້ານ ນາແກ	ບ້ານ ແກ້ງໄລ່	ບ້ານ ແກ້ງຕື້ນ				
ບ້ານ ໂພນໄຊ	ບ້ານ ທີ 6	ບ້ານ ຫຼັກ 23	 				
ບ້ານ ສຳນັກເມືອງ	ບ້ານ ໝື່ນຫຼວງ	ບ້ານ ຫ້ວຍລືສີ	 				
ລະຫັດໄປສະນີ ເຂດ 3: 16092				
ບ້ານ ທົ່ງທິງ	ບ້ານ ຫຼັກ 20	ບ້ານ ໝາກແງວ	ບ້ານ ອຸດົມສຸກ				
ບ້ານ ໂນນອຸດົມ	ບ້ານ ນິຄົມໃສ	ບ້ານ ປາຫຼາຍ	ບ້ານ ພີນ				
ບ້ານ ໂພນໄຜ່	ບ້ານ ຈຽງໄຊ	ບ້ານ ທີ 1	 				
ບ້ານ ຫົວຂົວແກ້ງເຈຍ	ບ້ານ ເພລາດ	ບ້ານ ພູທອງເທິງ	 				
ລະຫັດໄປສະນີ ເຂດ 4: 16093				
ບ້ານ ຫຼັກ 25	ບ້ານ ສົງຄອນ	ບ້ານ ຫຼັກ 19	ບ້ານ ໂນນ				
ບ້ານ ລົມສັກໃຕ້	ບ້ານ ເມິ້ງ	ບ້ານ ຫຼັກ 15	ບ້ານ ທີ 9				
ບ້ານ ຄຽງຕັງແລ	ບ້ານ ທົ່ງສາລາ	ບ້ານ ໜອງນ້ຳຂາວໃຫຍ່	ບ້ານ ທົ່ງຈານ				
ບ້ານ ທົ່ງກິມ	ບ້ານ ທົ່ງເພົາ	ບ້ານ ໜອງສິມ	 				
ລະຫັດໄປສະນີ ເຂດ 5: 16094				
ບ້ານ ທີ 8 ແລະ ທີ 10	ບ້ານ ກະໂປ	ບ້ານ ເພຍລາດ	ບ້ານ ຫຼັກ 14				
ບ້ານ ຫ້ວຍເສີຍ	ບ້ານ ໜອງບົວທອງ	ບ້ານ ກວາງຊິ	ບ້ານ ໜອງນ້ຳຂາວນ້ອຍ				
ບ້ານ ຜາສ້ວມ	ບ້ານ ຫ້ວຍມູດ	ບ້ານ ກະຈິດ	ບ້ານ ໂດນ				
ບ້ານ ຫົວແຊຫຼັກ 8	ບ້ານ ແກ້ງເຈຍ	ບ້ານ ຫຼັກ 18	 				
ລະຫັດໄປສະນີ ເຂດ 6: 16095				
ບ້ານ ໜອງໃສ	ບ້ານ ປາກົວະ	ບ້ານ ຫ້ວຍຍາງ	ບ້ານ ໂພນທອງ				
ບ້ານ ທີ 2	ບ້ານ ຫຼັກ 21	ບ້ານ ແກ້ງຍາວ	ບ້ານ ໜອງກຸ້ງ				
ບ້ານ ທົ່ງອຸດົມ	ບ້ານ ຫ້ວຍເສັດ	ບ້ານ ແຂນລາຍ	ບ້ານ ຫຼັກ 17				
ບ້ານ ຂະຫຍອງແກ້ວ	ບ້ານ ຫ້ວຍເດື່ອ	ບ້ານ ບະແກງ	ບ້ານ ໜອງບົວຂາວ				
 	 	 	ບ້ານ ຫຼັກ 13				





ແຂວງ ອັດຕະປື
ເລກລະຫັດໄປສະນີ 17000
ແຂວງ ອັດຕະປື 17xxx
ເມືອງ ສາມະຄີໄຊ ລະຫັດໄປສະນີ 17000 - 17001 
ລະຫັດໄປສະນີ ເຂດ 1: 17000
ບ້ານຮົມ	ບ້ານ ສາມັກຄີ	ບ້ານ ແຄມຊັງ	ບ້ານ ໂສກຄຳ
ບ້ານ ກອງຮັງ	ບ້ານ ໄຊໂພສີ	ບ້ານ ເຊກອງ	ບ້ານ ໃຫຍ່ເຂກະໝານ
ບ້ານ ກະຍື	ບ້ານ ທ່າຫີນ	ບ້ານ ເຊໃຫຍ່	ບ້ານ ຕຳມໍເລີຍ
ບ້ານ ກະໂສມ	ບ້ານ ຫຼັກສາມ	ບ້ານ ໂພນສະວ່າງ	ບ້ານ ວັດຫຼວງ
ລະຫັດໄປສະນີ ເຂດ 2: 17001
ບ້ານ ສະເພົາທອງ	ບ້ານ ສອກ	ບ້ານ ຮະລາງ	ບ້ານ ລະຍາວເໜືອ
ບ້ານ ໄຊສະອາດ	ບ້ານ ຈຳປາວ	ບ້ານ ສີວິໄລ	ບ້ານ ລະຍາວໄຕ
ບ້ານ ລະຍາວກາງ	ບ້ານ ມື່ນຫົວເມືອງ	ບ້ານ ເມືອງໃໝ	ບ້ານ ເວີນແຄນ
ເມືອງ ໄຊເສດຖາ ລະຫັດໄປສະນີ 17010 - 17011
ລະຫັດໄປສະນີ ເຂດ 1: 17010
ບ້ານ ສົມໂຄດ	ບ້ານ ຄັນມະກ່ອງ	ບ້ານ ວັດຫຼວງ	ບ້ານ ຝັ່ງແດງ
ບ້ານ ສະແຄະ	ບ້ານ ຕວຍ	ບ້ານ ນ້ຳຫຽງ	ບ້ານ ແກ້ງໃຫຍ່
ບ້ານ ຫາດສະຕີ	ບ້ານ ຫາດຊັນ	ບ້ານ ທ່າລານ	ບ້ານ ເຜົາສຳພັນມີໄຊ
ລະຫັດໄປສະນີ ເຂດ 2: 17011
ບ້ານ ວັດທາດ	ບ້ານ ຊ້າຍ	ບ້ານ ແກ້ງໄຊ	ບ້ານ ໃຫຍ່ອຸດົມ
ບ້ານ ສະປວນ	ບ້ານ ດອນສິມ	ບ້ານ ພອກ	 
ບ້ານ ໄຊສີ	ບ້ານ ວັດເໜືອ	ບ້ານ ໂພໄຊ	 
ເມືອງ ສະໜາມໄຊ ລະຫັດໄປສະນີ 17020 - 17022 
ລະຫັດໄປສະນີ ເຂດ 1: 17020
ບ້ານ ແທ	ບ້ານ ດອນສູງ	ບ້ານ ກະແຊະ	ບ້ານ ຫາດຍາວ
ບ້ານ ທ່າຫີນ	ບ້ານ ຫາດຊາຍຄຳ	ບ້ານ ດອນ	ບ້ານ ອິນທີ
ບ້ານ ມິດສຳພັນ	ບ້ານ ບຸ່ງແກ້ວ	ບ້ານ ຫີນລາດ	ບ້ານ ອຸດົມສຸກ
ບ້ານ ຈູມໂພ	ບ້ານ ໜອງມ່ວງ	ບ້ານ ໃໝ່	ບ້ານ ຫາດອຸດົມໄຊ
ລະຫັດໄປສະນີ ເຂດ 2: 17021
ບ້ານ ຄັນໝາກນາວ	ບ້ານ ປາກບໍ	ບ້ານ ຄັງ	ບ້ານ ສົມປ່ອຍ
ບ້ານ ມັດກ້າ	ບ້ານ ຕະມໍຍອດ	ບ້ານ ດອນເສືອ	ບ້ານ ຫາດຊາຍສູງ
ບ້ານ ຈັນຕໍ	ບ້ານ ສະໝອງໄຕ	ບ້ານ ອຸດົມໄຊ	ບ້ານ ໄຊດອນໂຂງ
ລະຫັດໄປສະນີ ເຂດ 3: 17022
ບ້ານ ແບງວິໄລ	ບ້ານ ປິ່ນດົງ	ບ້ານ ຫາດພິລາ	ບ້ານ ໜອງຫີນ
ບ້ານ ໜອງແຂ້	ບ້ານ ປຸຍ	ບ້ານ ຕະເງົາ	ບ້ານ ພອນມະນີ
ບ້ານ ທ່າແສງຈັນ	ບ້ານ ດອນໃຜ່	ບ້ານ ນຳກົງ	ບ້ານ ໂພນສະອາດ
ເມືອງ ພູວົງ ລະຫັດໄປສະນີ 17030  
ບ້ານ ສົມບູນ	ບ້ານ ນາຊອນ	ບ້ານ ພູເກືອ	ບ້ານ ພູຍາງ
ບ້ານ ວົງສຳພັນ	ບ້ານ ວັງແຄນ	ບ້ານ ຄຳວົງສາ	ບ້ານ ວົງສົມພູ
ບ້ານ ວັງຍາງ	ບ້ານ ພູໂຮມ	ບ້ານ ລະມອງ	ບ້ານ ພູໄຊ
ບ້ານ ວຽງໄຊ	ບ້ານ ນ້ຳກົງ	ບ້ານ ວົງລະຄອນ	 
ເມືອງ ຊານໄຊ ລະຫັດໄປສະນີ 17040 - 17042  
ລະຫັດໄປສະນີ ເຂດ 1: 17040
ບ້ານ ສົມບູນ	ບ້ານ ດອກປອກໃໝ	ບ້ານ ດາກເບນ	ບ້ານ ພູໄຊ
ບ້ານ ເພຍແກ້ວ	ບ້ານ ດາກຍົກ	ບ້ານ ວັງຕັດນ້ອຍ	ບ້ານ ຕາດແສງ
ບ້ານ ດາກກຽດ	ບ້ານ ນຳງອນໄຕ	ບ້ານ ໜອງໄກ່ໂອກ	ບ້ານ ຈະເລີນໄຊ
ບ້ານ ດອນແຄນ	ບ້ານ ດາກລະ	ບ້ານ ວັງໄຊ	ບ້ານ ດາຊຶມ
ລະຫັດໄປສະນີ ເຂດ 2: 17041
ບ້ານ ດາກສະມໍ	ບ້ານ ວັງຕັດໃຫຍ່	ບ້ານ ດາກກະນາດ	ບ້ານ ດາກສັງ
ບ້ານ ກອງນາ	ບ້ານ ດາກຮຽດ	ບ້ານ ດາກສຽດ	ບ້ານ ສຸກສະຫວ່າງ
ບ້ານ ໃໝຖາວອນ	ບ້ານ ຕາດກຸ່ມ	ບ້ານ ດາກນົງ	ບ້ານ ດາກບ໋ອກ
ບ້ານ ດາກປະດຸ	ບ້ານ ມູນ	ບ້ານ ດາກລຽມ	ບ້ານ ມີໄຊ
ລະຫັດໄປສະນີ ເຂດ 3: 17042
ບ້ານ ໃໝ່ນາກອກ	ບ້ານ ດາກດຼໍ	ບ້ານ ດອນຈັນ	ບ້ານ ຢຽກດາກ
ບ້ານ ຫີນດຳ	ບ້ານ ນ້ຳງອນເໜືອ	ບ້ານ ດາຊາວ	ບ້ານ ໜອງຟ້າ
ບ້ານ ດາກປອກເກົ່າ			 
ໄປສະນີ ບ້ານ ເມື່ອນຫົວເມືອງ ລະຫັດໄປສະນີ 17050 ຂຶ້ນກັບເມືອງສາມັກຄີໄຊ
ແຂວງ ໄຊສົມບູນ
ເລກລະຫັດໄປສະນີ 18000
ແຂວງ ໄຊສົມບູນ 18xxx							
ເມືອງ ອານຸວົງ ລະຫັດໄປສະນີ  18000 - 18003  							
ລະຫັດໄປສະນີ ເຂດ 1: 18000							
ບ້ານ ພູຫົວຊ້າງ	ບ້ານ ຜາສະຫງົບ	ບ້ານ ທົ່ງຄູນ	ບ້ານ ທົ່ງຮັກ							
ບ້ານ ອ່າວເໜືອ	ບ້ານ ອ່າວກາງ	ບ້ານ ອ່າວໃຕ້	 							
ລະຫັດໄປສະນີ ເຂດ 2: 18001  							
ບ້ານ ນໍ້າຍອນ	ບ້ານ ນໍ້າໂມ້	ບ້ານ ນ້ຳຈັ້ງ	 							
ລະຫັດໄປສະນີ ເຂດ 3: 18002 							
ບ້ານ ອອມ	ບ້ານ ຖ້ຳໂລ້	ບ້ານ ນາດີ	ບ້ານ ກໍໄຮ							
ລະຫັດໄປສະນີ ເຂດ 4: 18003 							
ບ້ານ ຫີນຫົວເສືອ	ບ້ານ ຫຼັກ 18	ບ້ານ ຫຼັກ 24	ບ້ານ ມ່ວງສູມ							
ບ້ານ ໂພນພະ			 							
ເມືອງຮົ່ມ ລະຫັດໄປສະນີ  18010  							
ບ້ານ ນໍ້າຄຽນ	ບ້ານ ຜາລະແວກ	ບ້ານ ຮົ່ມທາດ	ບ້ານ ສັນຊາວ							
ບ້ານ ຊຽງມີ	ບ້ານ ນາໂພ	ບ້ານ ຫ້ວຍຊາຍ	ບ້ານ ພູກາທະ							
ບ້ານ ນ້ຳຖວຍ			 							
ເມືອງ ລ້ອງຊານ ລະຫັດໄປສະນີ  18020 - 18021							
ລະຫັດໄປສະນີ ເຂດ 1: 18020							
ບ້ານ ຄອນວັດ	ບ້ານ ຫີນສໍ	ບ້ານ ຊາຄອນ	ບ້ານ ໂພນເລົ່າ							
ບ້ານ ວັງຫຼວງ	ບ້ານ ໂພນມ່ວງ	ບ້ານ ພູປ່າມັນ	ບ້ານ ຖ້ຳດິນ							
ບ້ານ ນາໄຊ	ບ້ານ ໂພນໄຊ	ບ້ານ ນ້ຳຄຸຍ	 							
ລະຫັດໄປສະນີ ເຂດ 2: 18021 							
ບ້ານ ໂພນສະອາດ	ບ້ານ ໂພນສະຫວາດ	ບ້ານ ດອນສຳພັນ	ບ້ານ ສັນປາຕອງ							
ບ້ານ ນາມອນ	ບ້ານ ແກ້ວສາມີ	ບ້ານ ນ້ຳເຢັນ	ບ້ານ ນ້ຳມຸ່ງ							
ເມືອງ ລ້ອງແຈ້ງລະຫັດໄປສະນີ  18030 							
ບ້ານ ລ້ອງແຈ້ງ	ບ້ານ ຊຳທອງ	ບ້ານ ນ້ຳຊານ	ບ້ານ ນ້ຳຊາວ							
ບ້ານ ພັນໄຊ	ບ້ານ ຫຼວງພັນໄຊ	ບ້ານ ນາໄຊສະຫວ່າງ	 	 						
ບ້ານ ນາຕີ	ບ້ານ ໜອງພຸມໄຊ	ບ້ານ ນ້ຳຜາ	 							
ເມືອງ ທ່າໂທມ ລະຫັດໄປສະນີ 18040 - 18041 							
ລະຫັດໄປສະນີ ເຂດ 1: 18040							
ບ້ານສີບຸນເຮືອງ	ບ້ານ ນ້ຳຜັງ	ບ້ານ ຊຽງຕັນ	ບ້ານ ນາຫີນບູນ							
ບ້ານ ໂພນຈະເລີນ	ບ້ານ ໂພນຮົ່ມ	ບ້ານ ຄອນສະນະ	ບ້ານ ຊຳກໍທອງ							
ບ້ານ ນ້ຳລໍ້			 							
ລະຫັດໄປສະນີ ເຂດ 2: 18041							
ບ້ານທ່າວຽງໄຊ	ບ້ານ ນາຊອງ	ບ້ານ ວຽງທອງ	ບ້ານ ຊຽງຄົງ							
ບ້ານ ໂພນໂຮມ	ບ້ານ ນາຫ້ອງ	ບ້ານ ພຽງຕາ	ບ້ານ ຫາບສຳຄອນ							
ບ້ານ ປູ້	ບ້ານ ສັນພູໄຊ	 	 							

